"","age","sex","settlement","year","province","populationtotal","populationnoted","populationed"
"1","10 ساله","پسر","روستا",1390,"آذربايجان شرقي",9093,416,8677
"2","11 ساله","پسر","روستا",1390,"آذربايجان شرقي",8776,545,8231
"3","12 ساله","پسر","روستا",1390,"آذربايجان شرقي",8891,734,8157
"4","13 ساله","پسر","روستا",1390,"آذربايجان شرقي",8819,929,7890
"5","14 ساله","پسر","روستا",1390,"آذربايجان شرقي",8774,1528,7246
"6","15 ساله","پسر","روستا",1390,"آذربايجان شرقي",9468,2455,7013
"7","16 ساله","پسر","روستا",1390,"آذربايجان شرقي",10215,3685,6530
"8","17 ساله","پسر","روستا",1390,"آذربايجان شرقي",11220,6134,5086
"9","18 ساله","پسر","روستا",1390,"آذربايجان شرقي",12533,8811,3722
"10","19 ساله","پسر","روستا",1390,"آذربايجان شرقي",12307,9572,2735
"11","6 ساله","پسر","روستا",1390,"آذربايجان شرقي",9660,2311,7349
"12","7 ساله","پسر","روستا",1390,"آذربايجان شرقي",9418,518,8900
"13","8 ساله","پسر","روستا",1390,"آذربايجان شرقي",9253,472,8781
"14","9 ساله","پسر","روستا",1390,"آذربايجان شرقي",9325,430,8895
"15","10 ساله","دختر","روستا",1390,"آذربايجان شرقي",8747,517,8230
"16","11 ساله","دختر","روستا",1390,"آذربايجان شرقي",8304,968,7336
"17","12 ساله","دختر","روستا",1390,"آذربايجان شرقي",8501,1414,7087
"18","13 ساله","دختر","روستا",1390,"آذربايجان شرقي",8412,2023,6389
"19","14 ساله","دختر","روستا",1390,"آذربايجان شرقي",8424,3283,5141
"20","15 ساله","دختر","روستا",1390,"آذربايجان شرقي",8820,4389,4431
"21","16 ساله","دختر","روستا",1390,"آذربايجان شرقي",9575,5427,4148
"22","17 ساله","دختر","روستا",1390,"آذربايجان شرقي",10369,7264,3105
"23","18 ساله","دختر","روستا",1390,"آذربايجان شرقي",10747,8764,1983
"24","19 ساله","دختر","روستا",1390,"آذربايجان شرقي",10631,8904,1727
"25","6 ساله","دختر","روستا",1390,"آذربايجان شرقي",9084,2138,6946
"26","7 ساله","دختر","روستا",1390,"آذربايجان شرقي",8781,496,8285
"27","8 ساله","دختر","روستا",1390,"آذربايجان شرقي",8841,420,8421
"28","9 ساله","دختر","روستا",1390,"آذربايجان شرقي",8864,473,8391
"29","10 ساله","پسر","شهر",1390,"آذربايجان شرقي",18933,581,18352
"30","11 ساله","پسر","شهر",1390,"آذربايجان شرقي",18135,506,17629
"31","12 ساله","پسر","شهر",1390,"آذربايجان شرقي",18087,504,17583
"32","13 ساله","پسر","شهر",1390,"آذربايجان شرقي",18080,605,17475
"33","14 ساله","پسر","شهر",1390,"آذربايجان شرقي",17806,929,16877
"34","15 ساله","پسر","شهر",1390,"آذربايجان شرقي",18063,1529,16534
"35","16 ساله","پسر","شهر",1390,"آذربايجان شرقي",18784,2508,16276
"36","17 ساله","پسر","شهر",1390,"آذربايجان شرقي",19580,5335,14245
"37","18 ساله","پسر","شهر",1390,"آذربايجان شرقي",20882,8760,12122
"38","19 ساله","پسر","شهر",1390,"آذربايجان شرقي",22627,10205,12422
"39","6 ساله","پسر","شهر",1390,"آذربايجان شرقي",17961,3851,14110
"40","7 ساله","پسر","شهر",1390,"آذربايجان شرقي",17311,681,16630
"41","8 ساله","پسر","شهر",1390,"آذربايجان شرقي",17156,591,16565
"42","9 ساله","پسر","شهر",1390,"آذربايجان شرقي",17290,573,16717
"43","10 ساله","دختر","شهر",1390,"آذربايجان شرقي",18178,534,17644
"44","11 ساله","دختر","شهر",1390,"آذربايجان شرقي",17246,499,16747
"45","12 ساله","دختر","شهر",1390,"آذربايجان شرقي",17260,528,16732
"46","13 ساله","دختر","شهر",1390,"آذربايجان شرقي",17234,713,16521
"47","14 ساله","دختر","شهر",1390,"آذربايجان شرقي",17270,1154,16116
"48","15 ساله","دختر","شهر",1390,"آذربايجان شرقي",17020,2031,14989
"49","16 ساله","دختر","شهر",1390,"آذربايجان شرقي",17890,3117,14773
"50","17 ساله","دختر","شهر",1390,"آذربايجان شرقي",19517,6341,13176
"51","18 ساله","دختر","شهر",1390,"آذربايجان شرقي",20673,10678,9995
"52","19 ساله","دختر","شهر",1390,"آذربايجان شرقي",21850,11179,10671
"53","6 ساله","دختر","شهر",1390,"آذربايجان شرقي",17108,3537,13571
"54","7 ساله","دختر","شهر",1390,"آذربايجان شرقي",16162,631,15531
"55","8 ساله","دختر","شهر",1390,"آذربايجان شرقي",16686,495,16191
"56","9 ساله","دختر","شهر",1390,"آذربايجان شرقي",16581,468,16113
"57","10 ساله","پسر","غیرساکن",1390,"آذربايجان شرقي",0,0,0
"58","11 ساله","پسر","غیرساکن",1390,"آذربايجان شرقي",0,0,0
"59","12 ساله","پسر","غیرساکن",1390,"آذربايجان شرقي",0,0,0
"60","13 ساله","پسر","غیرساکن",1390,"آذربايجان شرقي",0,0,0
"61","14 ساله","پسر","غیرساکن",1390,"آذربايجان شرقي",0,0,0
"62","15 ساله","پسر","غیرساکن",1390,"آذربايجان شرقي",0,0,0
"63","16 ساله","پسر","غیرساکن",1390,"آذربايجان شرقي",0,0,0
"64","17 ساله","پسر","غیرساکن",1390,"آذربايجان شرقي",0,0,0
"65","18 ساله","پسر","غیرساکن",1390,"آذربايجان شرقي",0,0,0
"66","19 ساله","پسر","غیرساکن",1390,"آذربايجان شرقي",0,0,0
"67","6 ساله","پسر","غیرساکن",1390,"آذربايجان شرقي",0,0,0
"68","7 ساله","پسر","غیرساکن",1390,"آذربايجان شرقي",0,0,0
"69","8 ساله","پسر","غیرساکن",1390,"آذربايجان شرقي",0,0,0
"70","9 ساله","پسر","غیرساکن",1390,"آذربايجان شرقي",0,0,0
"71","10 ساله","دختر","غیرساکن",1390,"آذربايجان شرقي",0,0,0
"72","11 ساله","دختر","غیرساکن",1390,"آذربايجان شرقي",0,0,0
"73","12 ساله","دختر","غیرساکن",1390,"آذربايجان شرقي",0,0,0
"74","13 ساله","دختر","غیرساکن",1390,"آذربايجان شرقي",0,0,0
"75","14 ساله","دختر","غیرساکن",1390,"آذربايجان شرقي",0,0,0
"76","15 ساله","دختر","غیرساکن",1390,"آذربايجان شرقي",0,0,0
"77","16 ساله","دختر","غیرساکن",1390,"آذربايجان شرقي",0,0,0
"78","17 ساله","دختر","غیرساکن",1390,"آذربايجان شرقي",0,0,0
"79","18 ساله","دختر","غیرساکن",1390,"آذربايجان شرقي",0,0,0
"80","19 ساله","دختر","غیرساکن",1390,"آذربايجان شرقي",0,0,0
"81","6 ساله","دختر","غیرساکن",1390,"آذربايجان شرقي",0,0,0
"82","7 ساله","دختر","غیرساکن",1390,"آذربايجان شرقي",0,0,0
"83","8 ساله","دختر","غیرساکن",1390,"آذربايجان شرقي",0,0,0
"84","9 ساله","دختر","غیرساکن",1390,"آذربايجان شرقي",0,0,0
"85","10 ساله","پسر","روستا",1390,"آذربايجان غربي",9766,505,9261
"86","11 ساله","پسر","روستا",1390,"آذربايجان غربي",9629,685,8944
"87","12 ساله","پسر","روستا",1390,"آذربايجان غربي",9721,1014,8707
"88","13 ساله","پسر","روستا",1390,"آذربايجان غربي",10179,1504,8675
"89","14 ساله","پسر","روستا",1390,"آذربايجان غربي",10595,2240,8355
"90","15 ساله","پسر","روستا",1390,"آذربايجان غربي",10739,3347,7392
"91","16 ساله","پسر","روستا",1390,"آذربايجان غربي",11818,5035,6783
"92","17 ساله","پسر","روستا",1390,"آذربايجان غربي",12662,7152,5510
"93","18 ساله","پسر","روستا",1390,"آذربايجان غربي",13856,9765,4091
"94","19 ساله","پسر","روستا",1390,"آذربايجان غربي",13834,10496,3338
"95","6 ساله","پسر","روستا",1390,"آذربايجان غربي",10776,2593,8183
"96","7 ساله","پسر","روستا",1390,"آذربايجان غربي",10575,575,10000
"97","8 ساله","پسر","روستا",1390,"آذربايجان غربي",9945,489,9456
"98","9 ساله","پسر","روستا",1390,"آذربايجان غربي",10060,528,9532
"99","10 ساله","دختر","روستا",1390,"آذربايجان غربي",9414,805,8609
"100","11 ساله","دختر","روستا",1390,"آذربايجان غربي",9179,1609,7570
"101","12 ساله","دختر","روستا",1390,"آذربايجان غربي",9571,2660,6911
"102","13 ساله","دختر","روستا",1390,"آذربايجان غربي",9990,3780,6210
"103","14 ساله","دختر","روستا",1390,"آذربايجان غربي",10019,4800,5219
"104","15 ساله","دختر","روستا",1390,"آذربايجان غربي",10166,6002,4164
"105","16 ساله","دختر","روستا",1390,"آذربايجان غربي",11596,7605,3991
"106","17 ساله","دختر","روستا",1390,"آذربايجان غربي",12340,9260,3080
"107","18 ساله","دختر","روستا",1390,"آذربايجان غربي",12847,10796,2051
"108","19 ساله","دختر","روستا",1390,"آذربايجان غربي",13118,11227,1891
"109","6 ساله","دختر","روستا",1390,"آذربايجان غربي",10162,2619,7543
"110","7 ساله","دختر","روستا",1390,"آذربايجان غربي",9837,607,9230
"111","8 ساله","دختر","روستا",1390,"آذربايجان غربي",9438,599,8839
"112","9 ساله","دختر","روستا",1390,"آذربايجان غربي",9701,664,9037
"113","10 ساله","پسر","شهر",1390,"آذربايجان غربي",16039,571,15468
"114","11 ساله","پسر","شهر",1390,"آذربايجان غربي",15448,492,14956
"115","12 ساله","پسر","شهر",1390,"آذربايجان غربي",15827,590,15237
"116","13 ساله","پسر","شهر",1390,"آذربايجان غربي",15812,799,15013
"117","14 ساله","پسر","شهر",1390,"آذربايجان غربي",16038,1160,14878
"118","15 ساله","پسر","شهر",1390,"آذربايجان غربي",15533,1910,13623
"119","16 ساله","پسر","شهر",1390,"آذربايجان غربي",16900,3157,13743
"120","17 ساله","پسر","شهر",1390,"آذربايجان غربي",17942,5584,12358
"121","18 ساله","پسر","شهر",1390,"آذربايجان غربي",18995,8671,10324
"122","19 ساله","پسر","شهر",1390,"آذربايجان غربي",19268,9638,9630
"123","6 ساله","پسر","شهر",1390,"آذربايجان غربي",15506,3431,12075
"124","7 ساله","پسر","شهر",1390,"آذربايجان غربي",14921,593,14328
"125","8 ساله","پسر","شهر",1390,"آذربايجان غربي",15009,500,14509
"126","9 ساله","پسر","شهر",1390,"آذربايجان غربي",14881,507,14374
"127","10 ساله","دختر","شهر",1390,"آذربايجان غربي",15473,622,14851
"128","11 ساله","دختر","شهر",1390,"آذربايجان غربي",14717,601,14116
"129","12 ساله","دختر","شهر",1390,"آذربايجان غربي",15089,883,14206
"130","13 ساله","دختر","شهر",1390,"آذربايجان غربي",15223,1167,14056
"131","14 ساله","دختر","شهر",1390,"آذربايجان غربي",15674,2015,13659
"132","15 ساله","دختر","شهر",1390,"آذربايجان غربي",14831,2873,11958
"133","16 ساله","دختر","شهر",1390,"آذربايجان غربي",16317,4277,12040
"134","17 ساله","دختر","شهر",1390,"آذربايجان غربي",17574,6791,10783
"135","18 ساله","دختر","شهر",1390,"آذربايجان غربي",18619,10528,8091
"136","19 ساله","دختر","شهر",1390,"آذربايجان غربي",19570,11163,8407
"137","6 ساله","دختر","شهر",1390,"آذربايجان غربي",14839,3346,11493
"138","7 ساله","دختر","شهر",1390,"آذربايجان غربي",13790,526,13264
"139","8 ساله","دختر","شهر",1390,"آذربايجان غربي",13996,472,13524
"140","9 ساله","دختر","شهر",1390,"آذربايجان غربي",14036,469,13567
"141","10 ساله","پسر","غیرساکن",1390,"آذربايجان غربي",0,0,0
"142","11 ساله","پسر","غیرساکن",1390,"آذربايجان غربي",0,0,0
"143","12 ساله","پسر","غیرساکن",1390,"آذربايجان غربي",0,0,0
"144","13 ساله","پسر","غیرساکن",1390,"آذربايجان غربي",0,0,0
"145","14 ساله","پسر","غیرساکن",1390,"آذربايجان غربي",0,0,0
"146","15 ساله","پسر","غیرساکن",1390,"آذربايجان غربي",0,0,0
"147","16 ساله","پسر","غیرساکن",1390,"آذربايجان غربي",0,0,0
"148","17 ساله","پسر","غیرساکن",1390,"آذربايجان غربي",0,0,0
"149","18 ساله","پسر","غیرساکن",1390,"آذربايجان غربي",0,0,0
"150","19 ساله","پسر","غیرساکن",1390,"آذربايجان غربي",0,0,0
"151","6 ساله","پسر","غیرساکن",1390,"آذربايجان غربي",0,0,0
"152","7 ساله","پسر","غیرساکن",1390,"آذربايجان غربي",0,0,0
"153","8 ساله","پسر","غیرساکن",1390,"آذربايجان غربي",0,0,0
"154","9 ساله","پسر","غیرساکن",1390,"آذربايجان غربي",0,0,0
"155","10 ساله","دختر","غیرساکن",1390,"آذربايجان غربي",0,0,0
"156","11 ساله","دختر","غیرساکن",1390,"آذربايجان غربي",0,0,0
"157","12 ساله","دختر","غیرساکن",1390,"آذربايجان غربي",0,0,0
"158","13 ساله","دختر","غیرساکن",1390,"آذربايجان غربي",0,0,0
"159","14 ساله","دختر","غیرساکن",1390,"آذربايجان غربي",0,0,0
"160","15 ساله","دختر","غیرساکن",1390,"آذربايجان غربي",0,0,0
"161","16 ساله","دختر","غیرساکن",1390,"آذربايجان غربي",0,0,0
"162","17 ساله","دختر","غیرساکن",1390,"آذربايجان غربي",0,0,0
"163","18 ساله","دختر","غیرساکن",1390,"آذربايجان غربي",0,0,0
"164","19 ساله","دختر","غیرساکن",1390,"آذربايجان غربي",0,0,0
"165","6 ساله","دختر","غیرساکن",1390,"آذربايجان غربي",0,0,0
"166","7 ساله","دختر","غیرساکن",1390,"آذربايجان غربي",0,0,0
"167","8 ساله","دختر","غیرساکن",1390,"آذربايجان غربي",0,0,0
"168","9 ساله","دختر","غیرساکن",1390,"آذربايجان غربي",0,0,0
"169","10 ساله","پسر","روستا",1390,"اردبيل",3389,121,3268
"170","11 ساله","پسر","روستا",1390,"اردبيل",3347,187,3160
"171","12 ساله","پسر","روستا",1390,"اردبيل",3645,226,3419
"172","13 ساله","پسر","روستا",1390,"اردبيل",3879,419,3460
"173","14 ساله","پسر","روستا",1390,"اردبيل",3932,684,3248
"174","15 ساله","پسر","روستا",1390,"اردبيل",4261,1142,3119
"175","16 ساله","پسر","روستا",1390,"اردبيل",4844,1733,3111
"176","17 ساله","پسر","روستا",1390,"اردبيل",5390,3000,2390
"177","18 ساله","پسر","روستا",1390,"اردبيل",5708,4090,1618
"178","19 ساله","پسر","روستا",1390,"اردبيل",5190,3889,1301
"179","6 ساله","پسر","روستا",1390,"اردبيل",3474,734,2740
"180","7 ساله","پسر","روستا",1390,"اردبيل",3402,125,3277
"181","8 ساله","پسر","روستا",1390,"اردبيل",3227,135,3092
"182","9 ساله","پسر","روستا",1390,"اردبيل",3289,120,3169
"183","10 ساله","دختر","روستا",1390,"اردبيل",3421,141,3280
"184","11 ساله","دختر","روستا",1390,"اردبيل",3229,283,2946
"185","12 ساله","دختر","روستا",1390,"اردبيل",3468,504,2964
"186","13 ساله","دختر","روستا",1390,"اردبيل",3554,798,2756
"187","14 ساله","دختر","روستا",1390,"اردبيل",3835,1330,2505
"188","15 ساله","دختر","روستا",1390,"اردبيل",3980,1753,2227
"189","16 ساله","دختر","روستا",1390,"اردبيل",4484,2297,2187
"190","17 ساله","دختر","روستا",1390,"اردبيل",4796,2983,1813
"191","18 ساله","دختر","روستا",1390,"اردبيل",5020,3917,1103
"192","19 ساله","دختر","روستا",1390,"اردبيل",4750,3872,878
"193","6 ساله","دختر","روستا",1390,"اردبيل",3221,688,2533
"194","7 ساله","دختر","روستا",1390,"اردبيل",3124,110,3014
"195","8 ساله","دختر","روستا",1390,"اردبيل",3093,98,2995
"196","9 ساله","دختر","روستا",1390,"اردبيل",3241,134,3107
"197","10 ساله","پسر","شهر",1390,"اردبيل",5997,130,5867
"198","11 ساله","پسر","شهر",1390,"اردبيل",5891,122,5769
"199","12 ساله","پسر","شهر",1390,"اردبيل",6117,177,5940
"200","13 ساله","پسر","شهر",1390,"اردبيل",6205,243,5962
"201","14 ساله","پسر","شهر",1390,"اردبيل",6540,407,6133
"202","15 ساله","پسر","شهر",1390,"اردبيل",6533,669,5864
"203","16 ساله","پسر","شهر",1390,"اردبيل",7311,1064,6247
"204","17 ساله","پسر","شهر",1390,"اردبيل",7462,2320,5142
"205","18 ساله","پسر","شهر",1390,"اردبيل",7833,3643,4190
"206","19 ساله","پسر","شهر",1390,"اردبيل",7668,3779,3889
"207","6 ساله","پسر","شهر",1390,"اردبيل",6144,1147,4997
"208","7 ساله","پسر","شهر",1390,"اردبيل",5957,157,5800
"209","8 ساله","پسر","شهر",1390,"اردبيل",5934,150,5784
"210","9 ساله","پسر","شهر",1390,"اردبيل",5815,149,5666
"211","10 ساله","دختر","شهر",1390,"اردبيل",5770,115,5655
"212","11 ساله","دختر","شهر",1390,"اردبيل",5820,135,5685
"213","12 ساله","دختر","شهر",1390,"اردبيل",6028,157,5871
"214","13 ساله","دختر","شهر",1390,"اردبيل",5981,227,5754
"215","14 ساله","دختر","شهر",1390,"اردبيل",6348,448,5900
"216","15 ساله","دختر","شهر",1390,"اردبيل",6495,859,5636
"217","16 ساله","دختر","شهر",1390,"اردبيل",7189,1321,5868
"218","17 ساله","دختر","شهر",1390,"اردبيل",7286,2346,4940
"219","18 ساله","دختر","شهر",1390,"اردبيل",7861,4303,3558
"220","19 ساله","دختر","شهر",1390,"اردبيل",7968,4402,3566
"221","6 ساله","دختر","شهر",1390,"اردبيل",5815,1045,4770
"222","7 ساله","دختر","شهر",1390,"اردبيل",5616,154,5462
"223","8 ساله","دختر","شهر",1390,"اردبيل",5587,116,5471
"224","9 ساله","دختر","شهر",1390,"اردبيل",5544,92,5452
"225","10 ساله","پسر","غیرساکن",1390,"اردبيل",0,0,0
"226","11 ساله","پسر","غیرساکن",1390,"اردبيل",0,0,0
"227","12 ساله","پسر","غیرساکن",1390,"اردبيل",0,0,0
"228","13 ساله","پسر","غیرساکن",1390,"اردبيل",0,0,0
"229","14 ساله","پسر","غیرساکن",1390,"اردبيل",0,0,0
"230","15 ساله","پسر","غیرساکن",1390,"اردبيل",0,0,0
"231","16 ساله","پسر","غیرساکن",1390,"اردبيل",0,0,0
"232","17 ساله","پسر","غیرساکن",1390,"اردبيل",0,0,0
"233","18 ساله","پسر","غیرساکن",1390,"اردبيل",0,0,0
"234","19 ساله","پسر","غیرساکن",1390,"اردبيل",0,0,0
"235","6 ساله","پسر","غیرساکن",1390,"اردبيل",0,0,0
"236","7 ساله","پسر","غیرساکن",1390,"اردبيل",0,0,0
"237","8 ساله","پسر","غیرساکن",1390,"اردبيل",0,0,0
"238","9 ساله","پسر","غیرساکن",1390,"اردبيل",0,0,0
"239","10 ساله","دختر","غیرساکن",1390,"اردبيل",0,0,0
"240","11 ساله","دختر","غیرساکن",1390,"اردبيل",0,0,0
"241","12 ساله","دختر","غیرساکن",1390,"اردبيل",0,0,0
"242","13 ساله","دختر","غیرساکن",1390,"اردبيل",0,0,0
"243","14 ساله","دختر","غیرساکن",1390,"اردبيل",0,0,0
"244","15 ساله","دختر","غیرساکن",1390,"اردبيل",0,0,0
"245","16 ساله","دختر","غیرساکن",1390,"اردبيل",0,0,0
"246","17 ساله","دختر","غیرساکن",1390,"اردبيل",0,0,0
"247","18 ساله","دختر","غیرساکن",1390,"اردبيل",0,0,0
"248","19 ساله","دختر","غیرساکن",1390,"اردبيل",0,0,0
"249","6 ساله","دختر","غیرساکن",1390,"اردبيل",0,0,0
"250","7 ساله","دختر","غیرساکن",1390,"اردبيل",0,0,0
"251","8 ساله","دختر","غیرساکن",1390,"اردبيل",0,0,0
"252","9 ساله","دختر","غیرساکن",1390,"اردبيل",0,0,0
"253","10 ساله","پسر","روستا",1390,"اصفهان",5000,286,4714
"254","11 ساله","پسر","روستا",1390,"اصفهان",4974,304,4670
"255","12 ساله","پسر","روستا",1390,"اصفهان",5006,324,4682
"256","13 ساله","پسر","روستا",1390,"اصفهان",5020,387,4633
"257","14 ساله","پسر","روستا",1390,"اصفهان",4817,557,4260
"258","15 ساله","پسر","روستا",1390,"اصفهان",4992,945,4047
"259","16 ساله","پسر","روستا",1390,"اصفهان",5445,1400,4045
"260","17 ساله","پسر","روستا",1390,"اصفهان",5778,2685,3093
"261","18 ساله","پسر","روستا",1390,"اصفهان",6676,4435,2241
"262","19 ساله","پسر","روستا",1390,"اصفهان",7115,5234,1881
"263","6 ساله","پسر","روستا",1390,"اصفهان",5652,1468,4184
"264","7 ساله","پسر","روستا",1390,"اصفهان",5137,386,4751
"265","8 ساله","پسر","روستا",1390,"اصفهان",5077,343,4734
"266","9 ساله","پسر","روستا",1390,"اصفهان",4832,321,4511
"267","10 ساله","دختر","روستا",1390,"اصفهان",4712,298,4414
"268","11 ساله","دختر","روستا",1390,"اصفهان",4745,345,4400
"269","12 ساله","دختر","روستا",1390,"اصفهان",4856,365,4491
"270","13 ساله","دختر","روستا",1390,"اصفهان",4830,427,4403
"271","14 ساله","دختر","روستا",1390,"اصفهان",4813,673,4140
"272","15 ساله","دختر","روستا",1390,"اصفهان",4760,974,3786
"273","16 ساله","دختر","روستا",1390,"اصفهان",5303,1376,3927
"274","17 ساله","دختر","روستا",1390,"اصفهان",5610,2477,3133
"275","18 ساله","دختر","روستا",1390,"اصفهان",5991,3800,2191
"276","19 ساله","دختر","روستا",1390,"اصفهان",6318,4378,1940
"277","6 ساله","دختر","روستا",1390,"اصفهان",5189,1365,3824
"278","7 ساله","دختر","روستا",1390,"اصفهان",4793,389,4404
"279","8 ساله","دختر","روستا",1390,"اصفهان",4787,345,4442
"280","9 ساله","دختر","روستا",1390,"اصفهان",4604,294,4310
"281","10 ساله","پسر","شهر",1390,"اصفهان",29867,964,28903
"282","11 ساله","پسر","شهر",1390,"اصفهان",29358,1003,28355
"283","12 ساله","پسر","شهر",1390,"اصفهان",29605,1108,28497
"284","13 ساله","پسر","شهر",1390,"اصفهان",28864,1296,27568
"285","14 ساله","پسر","شهر",1390,"اصفهان",28821,1805,27016
"286","15 ساله","پسر","شهر",1390,"اصفهان",28774,3188,25586
"287","16 ساله","پسر","شهر",1390,"اصفهان",30161,4803,25358
"288","17 ساله","پسر","شهر",1390,"اصفهان",32199,9373,22826
"289","18 ساله","پسر","شهر",1390,"اصفهان",34318,14500,19818
"290","19 ساله","پسر","شهر",1390,"اصفهان",35473,16467,19006
"291","6 ساله","پسر","شهر",1390,"اصفهان",29292,6989,22303
"292","7 ساله","پسر","شهر",1390,"اصفهان",27214,1378,25836
"293","8 ساله","پسر","شهر",1390,"اصفهان",27827,1104,26723
"294","9 ساله","پسر","شهر",1390,"اصفهان",27558,924,26634
"295","10 ساله","دختر","شهر",1390,"اصفهان",28498,958,27540
"296","11 ساله","دختر","شهر",1390,"اصفهان",28368,972,27396
"297","12 ساله","دختر","شهر",1390,"اصفهان",28284,1076,27208
"298","13 ساله","دختر","شهر",1390,"اصفهان",28009,1202,26807
"299","14 ساله","دختر","شهر",1390,"اصفهان",27861,1642,26219
"300","15 ساله","دختر","شهر",1390,"اصفهان",27717,2646,25071
"301","16 ساله","دختر","شهر",1390,"اصفهان",29027,3607,25420
"302","17 ساله","دختر","شهر",1390,"اصفهان",30905,8118,22787
"303","18 ساله","دختر","شهر",1390,"اصفهان",33623,14762,18861
"304","19 ساله","دختر","شهر",1390,"اصفهان",36716,16185,20531
"305","6 ساله","دختر","شهر",1390,"اصفهان",28128,6631,21497
"306","7 ساله","دختر","شهر",1390,"اصفهان",25811,1279,24532
"307","8 ساله","دختر","شهر",1390,"اصفهان",26511,1116,25395
"308","9 ساله","دختر","شهر",1390,"اصفهان",26080,899,25181
"309","10 ساله","پسر","غیرساکن",1390,"اصفهان",0,0,0
"310","11 ساله","پسر","غیرساکن",1390,"اصفهان",1,0,1
"311","12 ساله","پسر","غیرساکن",1390,"اصفهان",0,0,0
"312","13 ساله","پسر","غیرساکن",1390,"اصفهان",0,0,0
"313","14 ساله","پسر","غیرساکن",1390,"اصفهان",2,1,1
"314","15 ساله","پسر","غیرساکن",1390,"اصفهان",0,0,0
"315","16 ساله","پسر","غیرساکن",1390,"اصفهان",1,1,0
"316","17 ساله","پسر","غیرساکن",1390,"اصفهان",0,0,0
"317","18 ساله","پسر","غیرساکن",1390,"اصفهان",1,1,0
"318","19 ساله","پسر","غیرساکن",1390,"اصفهان",2,2,0
"319","6 ساله","پسر","غیرساکن",1390,"اصفهان",1,1,0
"320","7 ساله","پسر","غیرساکن",1390,"اصفهان",0,0,0
"321","8 ساله","پسر","غیرساکن",1390,"اصفهان",0,0,0
"322","9 ساله","پسر","غیرساکن",1390,"اصفهان",0,0,0
"323","10 ساله","دختر","غیرساکن",1390,"اصفهان",0,0,0
"324","11 ساله","دختر","غیرساکن",1390,"اصفهان",0,0,0
"325","12 ساله","دختر","غیرساکن",1390,"اصفهان",0,0,0
"326","13 ساله","دختر","غیرساکن",1390,"اصفهان",0,0,0
"327","14 ساله","دختر","غیرساکن",1390,"اصفهان",2,2,0
"328","15 ساله","دختر","غیرساکن",1390,"اصفهان",0,0,0
"329","16 ساله","دختر","غیرساکن",1390,"اصفهان",0,0,0
"330","17 ساله","دختر","غیرساکن",1390,"اصفهان",0,0,0
"331","18 ساله","دختر","غیرساکن",1390,"اصفهان",0,0,0
"332","19 ساله","دختر","غیرساکن",1390,"اصفهان",2,2,0
"333","6 ساله","دختر","غیرساکن",1390,"اصفهان",0,0,0
"334","7 ساله","دختر","غیرساکن",1390,"اصفهان",0,0,0
"335","8 ساله","دختر","غیرساکن",1390,"اصفهان",0,0,0
"336","9 ساله","دختر","غیرساکن",1390,"اصفهان",1,0,1
"337","10 ساله","پسر","روستا",1390,"البرز",1849,171,1678
"338","11 ساله","پسر","روستا",1390,"البرز",1695,136,1559
"339","12 ساله","پسر","روستا",1390,"البرز",1853,199,1654
"340","13 ساله","پسر","روستا",1390,"البرز",1893,238,1655
"341","14 ساله","پسر","روستا",1390,"البرز",1830,239,1591
"342","15 ساله","پسر","روستا",1390,"البرز",1921,343,1578
"343","16 ساله","پسر","روستا",1390,"البرز",1937,507,1430
"344","17 ساله","پسر","روستا",1390,"البرز",1996,880,1116
"345","18 ساله","پسر","روستا",1390,"البرز",2191,1289,902
"346","19 ساله","پسر","روستا",1390,"البرز",2077,1375,702
"347","6 ساله","پسر","روستا",1390,"البرز",1914,645,1269
"348","7 ساله","پسر","روستا",1390,"البرز",1874,225,1649
"349","8 ساله","پسر","روستا",1390,"البرز",1783,176,1607
"350","9 ساله","پسر","روستا",1390,"البرز",1729,150,1579
"351","10 ساله","دختر","روستا",1390,"البرز",1624,140,1484
"352","11 ساله","دختر","روستا",1390,"البرز",1638,174,1464
"353","12 ساله","دختر","روستا",1390,"البرز",1645,157,1488
"354","13 ساله","دختر","روستا",1390,"البرز",1762,201,1561
"355","14 ساله","دختر","روستا",1390,"البرز",1728,292,1436
"356","15 ساله","دختر","روستا",1390,"البرز",1765,404,1361
"357","16 ساله","دختر","روستا",1390,"البرز",1806,529,1277
"358","17 ساله","دختر","روستا",1390,"البرز",1871,817,1054
"359","18 ساله","دختر","روستا",1390,"البرز",1929,1233,696
"360","19 ساله","دختر","روستا",1390,"البرز",2038,1320,718
"361","6 ساله","دختر","روستا",1390,"البرز",1792,599,1193
"362","7 ساله","دختر","روستا",1390,"البرز",1700,223,1477
"363","8 ساله","دختر","روستا",1390,"البرز",1695,184,1511
"364","9 ساله","دختر","روستا",1390,"البرز",1667,162,1505
"365","10 ساله","پسر","شهر",1390,"البرز",15509,537,14972
"366","11 ساله","پسر","شهر",1390,"البرز",14846,491,14355
"367","12 ساله","پسر","شهر",1390,"البرز",14780,528,14252
"368","13 ساله","پسر","شهر",1390,"البرز",14878,610,14268
"369","14 ساله","پسر","شهر",1390,"البرز",14829,854,13975
"370","15 ساله","پسر","شهر",1390,"البرز",14605,1352,13253
"371","16 ساله","پسر","شهر",1390,"البرز",15513,2259,13254
"372","17 ساله","پسر","شهر",1390,"البرز",16214,4606,11608
"373","18 ساله","پسر","شهر",1390,"البرز",17311,7627,9684
"374","19 ساله","پسر","شهر",1390,"البرز",17178,8715,8463
"375","6 ساله","پسر","شهر",1390,"البرز",16228,3741,12487
"376","7 ساله","پسر","شهر",1390,"البرز",15291,710,14581
"377","8 ساله","پسر","شهر",1390,"البرز",14799,522,14277
"378","9 ساله","پسر","شهر",1390,"البرز",14377,503,13874
"379","10 ساله","دختر","شهر",1390,"البرز",15176,542,14634
"380","11 ساله","دختر","شهر",1390,"البرز",14121,428,13693
"381","12 ساله","دختر","شهر",1390,"البرز",14255,478,13777
"382","13 ساله","دختر","شهر",1390,"البرز",14429,545,13884
"383","14 ساله","دختر","شهر",1390,"البرز",14351,857,13494
"384","15 ساله","دختر","شهر",1390,"البرز",14217,1526,12691
"385","16 ساله","دختر","شهر",1390,"البرز",15130,2282,12848
"386","17 ساله","دختر","شهر",1390,"البرز",16344,4780,11564
"387","18 ساله","دختر","شهر",1390,"البرز",17385,8790,8595
"388","19 ساله","دختر","شهر",1390,"البرز",18612,9840,8772
"389","6 ساله","دختر","شهر",1390,"البرز",15162,3480,11682
"390","7 ساله","دختر","شهر",1390,"البرز",14183,630,13553
"391","8 ساله","دختر","شهر",1390,"البرز",14115,554,13561
"392","9 ساله","دختر","شهر",1390,"البرز",13457,443,13014
"393","10 ساله","پسر","غیرساکن",1390,"البرز",0,0,0
"394","11 ساله","پسر","غیرساکن",1390,"البرز",0,0,0
"395","12 ساله","پسر","غیرساکن",1390,"البرز",0,0,0
"396","13 ساله","پسر","غیرساکن",1390,"البرز",0,0,0
"397","14 ساله","پسر","غیرساکن",1390,"البرز",0,0,0
"398","15 ساله","پسر","غیرساکن",1390,"البرز",0,0,0
"399","16 ساله","پسر","غیرساکن",1390,"البرز",0,0,0
"400","17 ساله","پسر","غیرساکن",1390,"البرز",0,0,0
"401","18 ساله","پسر","غیرساکن",1390,"البرز",0,0,0
"402","19 ساله","پسر","غیرساکن",1390,"البرز",0,0,0
"403","6 ساله","پسر","غیرساکن",1390,"البرز",0,0,0
"404","7 ساله","پسر","غیرساکن",1390,"البرز",0,0,0
"405","8 ساله","پسر","غیرساکن",1390,"البرز",0,0,0
"406","9 ساله","پسر","غیرساکن",1390,"البرز",0,0,0
"407","10 ساله","دختر","غیرساکن",1390,"البرز",0,0,0
"408","11 ساله","دختر","غیرساکن",1390,"البرز",0,0,0
"409","12 ساله","دختر","غیرساکن",1390,"البرز",0,0,0
"410","13 ساله","دختر","غیرساکن",1390,"البرز",0,0,0
"411","14 ساله","دختر","غیرساکن",1390,"البرز",0,0,0
"412","15 ساله","دختر","غیرساکن",1390,"البرز",0,0,0
"413","16 ساله","دختر","غیرساکن",1390,"البرز",0,0,0
"414","17 ساله","دختر","غیرساکن",1390,"البرز",0,0,0
"415","18 ساله","دختر","غیرساکن",1390,"البرز",0,0,0
"416","19 ساله","دختر","غیرساکن",1390,"البرز",0,0,0
"417","6 ساله","دختر","غیرساکن",1390,"البرز",0,0,0
"418","7 ساله","دختر","غیرساکن",1390,"البرز",0,0,0
"419","8 ساله","دختر","غیرساکن",1390,"البرز",0,0,0
"420","9 ساله","دختر","غیرساکن",1390,"البرز",0,0,0
"421","10 ساله","پسر","روستا",1390,"ايلام",1393,100,1293
"422","11 ساله","پسر","روستا",1390,"ايلام",1436,120,1316
"423","12 ساله","پسر","روستا",1390,"ايلام",1490,117,1373
"424","13 ساله","پسر","روستا",1390,"ايلام",1514,181,1333
"425","14 ساله","پسر","روستا",1390,"ايلام",1590,231,1359
"426","15 ساله","پسر","روستا",1390,"ايلام",1755,339,1416
"427","16 ساله","پسر","روستا",1390,"ايلام",1980,492,1488
"428","17 ساله","پسر","روستا",1390,"ايلام",2267,943,1324
"429","18 ساله","پسر","روستا",1390,"ايلام",2273,1349,924
"430","19 ساله","پسر","روستا",1390,"ايلام",2565,1778,787
"431","6 ساله","پسر","روستا",1390,"ايلام",1533,379,1154
"432","7 ساله","پسر","روستا",1390,"ايلام",1447,87,1360
"433","8 ساله","پسر","روستا",1390,"ايلام",1352,83,1269
"434","9 ساله","پسر","روستا",1390,"ايلام",1359,96,1263
"435","10 ساله","دختر","روستا",1390,"ايلام",1323,114,1209
"436","11 ساله","دختر","روستا",1390,"ايلام",1284,122,1162
"437","12 ساله","دختر","روستا",1390,"ايلام",1408,184,1224
"438","13 ساله","دختر","روستا",1390,"ايلام",1400,216,1184
"439","14 ساله","دختر","روستا",1390,"ايلام",1472,325,1147
"440","15 ساله","دختر","روستا",1390,"ايلام",1750,495,1255
"441","16 ساله","دختر","روستا",1390,"ايلام",1858,599,1259
"442","17 ساله","دختر","روستا",1390,"ايلام",2147,1007,1140
"443","18 ساله","دختر","روستا",1390,"ايلام",2151,1450,701
"444","19 ساله","دختر","روستا",1390,"ايلام",2342,1639,703
"445","6 ساله","دختر","روستا",1390,"ايلام",1535,371,1164
"446","7 ساله","دختر","روستا",1390,"ايلام",1391,91,1300
"447","8 ساله","دختر","روستا",1390,"ايلام",1330,87,1243
"448","9 ساله","دختر","روستا",1390,"ايلام",1307,90,1217
"449","10 ساله","پسر","شهر",1390,"ايلام",2632,65,2567
"450","11 ساله","پسر","شهر",1390,"ايلام",2517,74,2443
"451","12 ساله","پسر","شهر",1390,"ايلام",2500,68,2432
"452","13 ساله","پسر","شهر",1390,"ايلام",2432,78,2354
"453","14 ساله","پسر","شهر",1390,"ايلام",2708,92,2616
"454","15 ساله","پسر","شهر",1390,"ايلام",2789,192,2597
"455","16 ساله","پسر","شهر",1390,"ايلام",3091,263,2828
"456","17 ساله","پسر","شهر",1390,"ايلام",3435,764,2671
"457","18 ساله","پسر","شهر",1390,"ايلام",3775,1572,2203
"458","19 ساله","پسر","شهر",1390,"ايلام",4104,1786,2318
"459","6 ساله","پسر","شهر",1390,"ايلام",2873,582,2291
"460","7 ساله","پسر","شهر",1390,"ايلام",2757,106,2651
"461","8 ساله","پسر","شهر",1390,"ايلام",2630,81,2549
"462","9 ساله","پسر","شهر",1390,"ايلام",2525,62,2463
"463","10 ساله","دختر","شهر",1390,"ايلام",2380,73,2307
"464","11 ساله","دختر","شهر",1390,"ايلام",2359,65,2294
"465","12 ساله","دختر","شهر",1390,"ايلام",2395,70,2325
"466","13 ساله","دختر","شهر",1390,"ايلام",2365,66,2299
"467","14 ساله","دختر","شهر",1390,"ايلام",2582,91,2491
"468","15 ساله","دختر","شهر",1390,"ايلام",2643,191,2452
"469","16 ساله","دختر","شهر",1390,"ايلام",2969,303,2666
"470","17 ساله","دختر","شهر",1390,"ايلام",3410,761,2649
"471","18 ساله","دختر","شهر",1390,"ايلام",3587,1656,1931
"472","19 ساله","دختر","شهر",1390,"ايلام",4228,1801,2427
"473","6 ساله","دختر","شهر",1390,"ايلام",2634,508,2126
"474","7 ساله","دختر","شهر",1390,"ايلام",2567,83,2484
"475","8 ساله","دختر","شهر",1390,"ايلام",2389,71,2318
"476","9 ساله","دختر","شهر",1390,"ايلام",2293,73,2220
"477","10 ساله","پسر","غیرساکن",1390,"ايلام",8,1,7
"478","11 ساله","پسر","غیرساکن",1390,"ايلام",9,3,6
"479","12 ساله","پسر","غیرساکن",1390,"ايلام",9,3,6
"480","13 ساله","پسر","غیرساکن",1390,"ايلام",14,5,9
"481","14 ساله","پسر","غیرساکن",1390,"ايلام",20,9,11
"482","15 ساله","پسر","غیرساکن",1390,"ايلام",20,10,10
"483","16 ساله","پسر","غیرساکن",1390,"ايلام",15,8,7
"484","17 ساله","پسر","غیرساکن",1390,"ايلام",27,22,5
"485","18 ساله","پسر","غیرساکن",1390,"ايلام",29,21,8
"486","19 ساله","پسر","غیرساکن",1390,"ايلام",20,17,3
"487","6 ساله","پسر","غیرساکن",1390,"ايلام",6,1,5
"488","7 ساله","پسر","غیرساکن",1390,"ايلام",14,2,12
"489","8 ساله","پسر","غیرساکن",1390,"ايلام",11,0,11
"490","9 ساله","پسر","غیرساکن",1390,"ايلام",12,2,10
"491","10 ساله","دختر","غیرساکن",1390,"ايلام",13,2,11
"492","11 ساله","دختر","غیرساکن",1390,"ايلام",9,2,7
"493","12 ساله","دختر","غیرساکن",1390,"ايلام",14,7,7
"494","13 ساله","دختر","غیرساکن",1390,"ايلام",11,8,3
"495","14 ساله","دختر","غیرساکن",1390,"ايلام",18,14,4
"496","15 ساله","دختر","غیرساکن",1390,"ايلام",11,8,3
"497","16 ساله","دختر","غیرساکن",1390,"ايلام",19,16,3
"498","17 ساله","دختر","غیرساکن",1390,"ايلام",15,14,1
"499","18 ساله","دختر","غیرساکن",1390,"ايلام",15,13,2
"500","19 ساله","دختر","غیرساکن",1390,"ايلام",20,18,2
"501","6 ساله","دختر","غیرساکن",1390,"ايلام",9,2,7
"502","7 ساله","دختر","غیرساکن",1390,"ايلام",14,2,12
"503","8 ساله","دختر","غیرساکن",1390,"ايلام",5,2,3
"504","9 ساله","دختر","غیرساکن",1390,"ايلام",16,3,13
"505","10 ساله","پسر","روستا",1390,"بوشهر",2268,80,2188
"506","11 ساله","پسر","روستا",1390,"بوشهر",2179,83,2096
"507","12 ساله","پسر","روستا",1390,"بوشهر",2331,103,2228
"508","13 ساله","پسر","روستا",1390,"بوشهر",2168,107,2061
"509","14 ساله","پسر","روستا",1390,"بوشهر",2157,156,2001
"510","15 ساله","پسر","روستا",1390,"بوشهر",2305,313,1992
"511","16 ساله","پسر","روستا",1390,"بوشهر",2508,503,2005
"512","17 ساله","پسر","روستا",1390,"بوشهر",2693,973,1720
"513","18 ساله","پسر","روستا",1390,"بوشهر",3141,1745,1396
"514","19 ساله","پسر","روستا",1390,"بوشهر",3292,2006,1286
"515","6 ساله","پسر","روستا",1390,"بوشهر",2777,674,2103
"516","7 ساله","پسر","روستا",1390,"بوشهر",2591,106,2485
"517","8 ساله","پسر","روستا",1390,"بوشهر",2500,101,2399
"518","9 ساله","پسر","روستا",1390,"بوشهر",2500,97,2403
"519","10 ساله","دختر","روستا",1390,"بوشهر",2212,79,2133
"520","11 ساله","دختر","روستا",1390,"بوشهر",2164,104,2060
"521","12 ساله","دختر","روستا",1390,"بوشهر",2100,129,1971
"522","13 ساله","دختر","روستا",1390,"بوشهر",2110,180,1930
"523","14 ساله","دختر","روستا",1390,"بوشهر",2008,257,1751
"524","15 ساله","دختر","روستا",1390,"بوشهر",2192,444,1748
"525","16 ساله","دختر","روستا",1390,"بوشهر",2455,624,1831
"526","17 ساله","دختر","روستا",1390,"بوشهر",2494,1073,1421
"527","18 ساله","دختر","روستا",1390,"بوشهر",2857,1811,1046
"528","19 ساله","دختر","روستا",1390,"بوشهر",3002,2090,912
"529","6 ساله","دختر","روستا",1390,"بوشهر",2755,639,2116
"530","7 ساله","دختر","روستا",1390,"بوشهر",2376,130,2246
"531","8 ساله","دختر","روستا",1390,"بوشهر",2349,96,2253
"532","9 ساله","دختر","روستا",1390,"بوشهر",2328,93,2235
"533","10 ساله","پسر","شهر",1390,"بوشهر",4995,261,4734
"534","11 ساله","پسر","شهر",1390,"بوشهر",4839,209,4630
"535","12 ساله","پسر","شهر",1390,"بوشهر",5068,279,4789
"536","13 ساله","پسر","شهر",1390,"بوشهر",4850,283,4567
"537","14 ساله","پسر","شهر",1390,"بوشهر",4989,394,4595
"538","15 ساله","پسر","شهر",1390,"بوشهر",5215,771,4444
"539","16 ساله","پسر","شهر",1390,"بوشهر",5678,1031,4647
"540","17 ساله","پسر","شهر",1390,"بوشهر",6055,1919,4136
"541","18 ساله","پسر","شهر",1390,"بوشهر",6560,3201,3359
"542","19 ساله","پسر","شهر",1390,"بوشهر",7640,4457,3183
"543","6 ساله","پسر","شهر",1390,"بوشهر",5746,1414,4332
"544","7 ساله","پسر","شهر",1390,"بوشهر",5451,370,5081
"545","8 ساله","پسر","شهر",1390,"بوشهر",5372,306,5066
"546","9 ساله","پسر","شهر",1390,"بوشهر",5302,290,5012
"547","10 ساله","دختر","شهر",1390,"بوشهر",4989,286,4703
"548","11 ساله","دختر","شهر",1390,"بوشهر",4720,264,4456
"549","12 ساله","دختر","شهر",1390,"بوشهر",4917,305,4612
"550","13 ساله","دختر","شهر",1390,"بوشهر",4833,360,4473
"551","14 ساله","دختر","شهر",1390,"بوشهر",4756,457,4299
"552","15 ساله","دختر","شهر",1390,"بوشهر",4884,619,4265
"553","16 ساله","دختر","شهر",1390,"بوشهر",5209,934,4275
"554","17 ساله","دختر","شهر",1390,"بوشهر",5545,1666,3879
"555","18 ساله","دختر","شهر",1390,"بوشهر",6030,3151,2879
"556","19 ساله","دختر","شهر",1390,"بوشهر",6539,3443,3096
"557","6 ساله","دختر","شهر",1390,"بوشهر",5544,1365,4179
"558","7 ساله","دختر","شهر",1390,"بوشهر",5153,342,4811
"559","8 ساله","دختر","شهر",1390,"بوشهر",5086,307,4779
"560","9 ساله","دختر","شهر",1390,"بوشهر",4876,261,4615
"561","10 ساله","پسر","غیرساکن",1390,"بوشهر",29,3,26
"562","11 ساله","پسر","غیرساکن",1390,"بوشهر",30,6,24
"563","12 ساله","پسر","غیرساکن",1390,"بوشهر",21,5,16
"564","13 ساله","پسر","غیرساکن",1390,"بوشهر",30,12,18
"565","14 ساله","پسر","غیرساکن",1390,"بوشهر",17,4,13
"566","15 ساله","پسر","غیرساکن",1390,"بوشهر",32,16,16
"567","16 ساله","پسر","غیرساکن",1390,"بوشهر",26,8,18
"568","17 ساله","پسر","غیرساکن",1390,"بوشهر",24,15,9
"569","18 ساله","پسر","غیرساکن",1390,"بوشهر",40,27,13
"570","19 ساله","پسر","غیرساکن",1390,"بوشهر",18,17,1
"571","6 ساله","پسر","غیرساکن",1390,"بوشهر",19,6,13
"572","7 ساله","پسر","غیرساکن",1390,"بوشهر",15,2,13
"573","8 ساله","پسر","غیرساکن",1390,"بوشهر",26,0,26
"574","9 ساله","پسر","غیرساکن",1390,"بوشهر",25,1,24
"575","10 ساله","دختر","غیرساکن",1390,"بوشهر",22,2,20
"576","11 ساله","دختر","غیرساکن",1390,"بوشهر",14,4,10
"577","12 ساله","دختر","غیرساکن",1390,"بوشهر",19,7,12
"578","13 ساله","دختر","غیرساکن",1390,"بوشهر",17,11,6
"579","14 ساله","دختر","غیرساکن",1390,"بوشهر",21,12,9
"580","15 ساله","دختر","غیرساکن",1390,"بوشهر",28,16,12
"581","16 ساله","دختر","غیرساکن",1390,"بوشهر",28,17,11
"582","17 ساله","دختر","غیرساکن",1390,"بوشهر",27,24,3
"583","18 ساله","دختر","غیرساکن",1390,"بوشهر",25,23,2
"584","19 ساله","دختر","غیرساکن",1390,"بوشهر",25,25,0
"585","6 ساله","دختر","غیرساکن",1390,"بوشهر",26,7,19
"586","7 ساله","دختر","غیرساکن",1390,"بوشهر",21,3,18
"587","8 ساله","دختر","غیرساکن",1390,"بوشهر",20,1,19
"588","9 ساله","دختر","غیرساکن",1390,"بوشهر",21,2,19
"589","10 ساله","پسر","روستا",1390,"تهران",7319,464,6855
"590","11 ساله","پسر","روستا",1390,"تهران",7010,436,6574
"591","12 ساله","پسر","روستا",1390,"تهران",7544,625,6919
"592","13 ساله","پسر","روستا",1390,"تهران",7414,740,6674
"593","14 ساله","پسر","روستا",1390,"تهران",7492,1105,6387
"594","15 ساله","پسر","روستا",1390,"تهران",7595,1728,5867
"595","16 ساله","پسر","روستا",1390,"تهران",7773,2438,5335
"596","17 ساله","پسر","روستا",1390,"تهران",8362,4179,4183
"597","18 ساله","پسر","روستا",1390,"تهران",8959,5831,3128
"598","19 ساله","پسر","روستا",1390,"تهران",9052,6827,2225
"599","6 ساله","پسر","روستا",1390,"تهران",7547,2438,5109
"600","7 ساله","پسر","روستا",1390,"تهران",7398,696,6702
"601","8 ساله","پسر","روستا",1390,"تهران",7220,520,6700
"602","9 ساله","پسر","روستا",1390,"تهران",6861,408,6453
"603","10 ساله","دختر","روستا",1390,"تهران",7026,463,6563
"604","11 ساله","دختر","روستا",1390,"تهران",6753,468,6285
"605","12 ساله","دختر","روستا",1390,"تهران",6918,591,6327
"606","13 ساله","دختر","روستا",1390,"تهران",6950,768,6182
"607","14 ساله","دختر","روستا",1390,"تهران",7037,1182,5855
"608","15 ساله","دختر","روستا",1390,"تهران",7257,1782,5475
"609","16 ساله","دختر","روستا",1390,"تهران",7199,2278,4921
"610","17 ساله","دختر","روستا",1390,"تهران",7593,3641,3952
"611","18 ساله","دختر","روستا",1390,"تهران",8260,5560,2700
"612","19 ساله","دختر","روستا",1390,"تهران",7927,5744,2183
"613","6 ساله","دختر","روستا",1390,"تهران",7288,2391,4897
"614","7 ساله","دختر","روستا",1390,"تهران",7095,652,6443
"615","8 ساله","دختر","روستا",1390,"تهران",7018,521,6497
"616","9 ساله","دختر","روستا",1390,"تهران",6393,409,5984
"617","10 ساله","پسر","شهر",1390,"تهران",79768,3695,76073
"618","11 ساله","پسر","شهر",1390,"تهران",74826,2865,71961
"619","12 ساله","پسر","شهر",1390,"تهران",76146,3056,73090
"620","13 ساله","پسر","شهر",1390,"تهران",74662,3394,71268
"621","14 ساله","پسر","شهر",1390,"تهران",74227,4555,69672
"622","15 ساله","پسر","شهر",1390,"تهران",73908,8211,65697
"623","16 ساله","پسر","شهر",1390,"تهران",76188,11949,64239
"624","17 ساله","پسر","شهر",1390,"تهران",80036,23173,56863
"625","18 ساله","پسر","شهر",1390,"تهران",86559,37101,49458
"626","19 ساله","پسر","شهر",1390,"تهران",88804,43397,45407
"627","6 ساله","پسر","شهر",1390,"تهران",74306,19157,55149
"628","7 ساله","پسر","شهر",1390,"تهران",70036,3779,66257
"629","8 ساله","پسر","شهر",1390,"تهران",70530,3103,67427
"630","9 ساله","پسر","شهر",1390,"تهران",68965,2943,66022
"631","10 ساله","دختر","شهر",1390,"تهران",77243,3445,73798
"632","11 ساله","دختر","شهر",1390,"تهران",72216,2651,69565
"633","12 ساله","دختر","شهر",1390,"تهران",72657,2965,69692
"634","13 ساله","دختر","شهر",1390,"تهران",71016,3065,67951
"635","14 ساله","دختر","شهر",1390,"تهران",70741,4388,66353
"636","15 ساله","دختر","شهر",1390,"تهران",71756,7483,64273
"637","16 ساله","دختر","شهر",1390,"تهران",73736,10930,62806
"638","17 ساله","دختر","شهر",1390,"تهران",78670,21640,57030
"639","18 ساله","دختر","شهر",1390,"تهران",85251,37214,48037
"640","19 ساله","دختر","شهر",1390,"تهران",90504,41019,49485
"641","6 ساله","دختر","شهر",1390,"تهران",71111,18231,52880
"642","7 ساله","دختر","شهر",1390,"تهران",67448,3486,63962
"643","8 ساله","دختر","شهر",1390,"تهران",66957,2921,64036
"644","9 ساله","دختر","شهر",1390,"تهران",65833,2696,63137
"645","10 ساله","پسر","غیرساکن",1390,"تهران",0,0,0
"646","11 ساله","پسر","غیرساکن",1390,"تهران",0,0,0
"647","12 ساله","پسر","غیرساکن",1390,"تهران",0,0,0
"648","13 ساله","پسر","غیرساکن",1390,"تهران",0,0,0
"649","14 ساله","پسر","غیرساکن",1390,"تهران",0,0,0
"650","15 ساله","پسر","غیرساکن",1390,"تهران",0,0,0
"651","16 ساله","پسر","غیرساکن",1390,"تهران",0,0,0
"652","17 ساله","پسر","غیرساکن",1390,"تهران",0,0,0
"653","18 ساله","پسر","غیرساکن",1390,"تهران",0,0,0
"654","19 ساله","پسر","غیرساکن",1390,"تهران",0,0,0
"655","6 ساله","پسر","غیرساکن",1390,"تهران",0,0,0
"656","7 ساله","پسر","غیرساکن",1390,"تهران",1,1,0
"657","8 ساله","پسر","غیرساکن",1390,"تهران",1,0,1
"658","9 ساله","پسر","غیرساکن",1390,"تهران",1,0,1
"659","10 ساله","دختر","غیرساکن",1390,"تهران",0,0,0
"660","11 ساله","دختر","غیرساکن",1390,"تهران",0,0,0
"661","12 ساله","دختر","غیرساکن",1390,"تهران",0,0,0
"662","13 ساله","دختر","غیرساکن",1390,"تهران",0,0,0
"663","14 ساله","دختر","غیرساکن",1390,"تهران",0,0,0
"664","15 ساله","دختر","غیرساکن",1390,"تهران",0,0,0
"665","16 ساله","دختر","غیرساکن",1390,"تهران",0,0,0
"666","17 ساله","دختر","غیرساکن",1390,"تهران",0,0,0
"667","18 ساله","دختر","غیرساکن",1390,"تهران",0,0,0
"668","19 ساله","دختر","غیرساکن",1390,"تهران",0,0,0
"669","6 ساله","دختر","غیرساکن",1390,"تهران",0,0,0
"670","7 ساله","دختر","غیرساکن",1390,"تهران",0,0,0
"671","8 ساله","دختر","غیرساکن",1390,"تهران",0,0,0
"672","9 ساله","دختر","غیرساکن",1390,"تهران",0,0,0
"673","10 ساله","پسر","روستا",1390,"چهارمحال وبختياري",2975,139,2836
"674","11 ساله","پسر","روستا",1390,"چهارمحال وبختياري",2893,151,2742
"675","12 ساله","پسر","روستا",1390,"چهارمحال وبختياري",3036,212,2824
"676","13 ساله","پسر","روستا",1390,"چهارمحال وبختياري",3275,278,2997
"677","14 ساله","پسر","روستا",1390,"چهارمحال وبختياري",3413,424,2989
"678","15 ساله","پسر","روستا",1390,"چهارمحال وبختياري",3451,687,2764
"679","16 ساله","پسر","روستا",1390,"چهارمحال وبختياري",3798,1114,2684
"680","17 ساله","پسر","روستا",1390,"چهارمحال وبختياري",4223,2040,2183
"681","18 ساله","پسر","روستا",1390,"چهارمحال وبختياري",4407,2780,1627
"682","19 ساله","پسر","روستا",1390,"چهارمحال وبختياري",4093,2913,1180
"683","6 ساله","پسر","روستا",1390,"چهارمحال وبختياري",3431,722,2709
"684","7 ساله","پسر","روستا",1390,"چهارمحال وبختياري",3346,183,3163
"685","8 ساله","پسر","روستا",1390,"چهارمحال وبختياري",3243,148,3095
"686","9 ساله","پسر","روستا",1390,"چهارمحال وبختياري",3031,139,2892
"687","10 ساله","دختر","روستا",1390,"چهارمحال وبختياري",3009,160,2849
"688","11 ساله","دختر","روستا",1390,"چهارمحال وبختياري",2818,209,2609
"689","12 ساله","دختر","روستا",1390,"چهارمحال وبختياري",3014,366,2648
"690","13 ساله","دختر","روستا",1390,"چهارمحال وبختياري",3215,524,2691
"691","14 ساله","دختر","روستا",1390,"چهارمحال وبختياري",3442,746,2696
"692","15 ساله","دختر","روستا",1390,"چهارمحال وبختياري",3412,1025,2387
"693","16 ساله","دختر","روستا",1390,"چهارمحال وبختياري",3840,1423,2417
"694","17 ساله","دختر","روستا",1390,"چهارمحال وبختياري",4177,2193,1984
"695","18 ساله","دختر","روستا",1390,"چهارمحال وبختياري",4517,3170,1347
"696","19 ساله","دختر","روستا",1390,"چهارمحال وبختياري",4622,3613,1009
"697","6 ساله","دختر","روستا",1390,"چهارمحال وبختياري",3236,665,2571
"698","7 ساله","دختر","روستا",1390,"چهارمحال وبختياري",3223,175,3048
"699","8 ساله","دختر","روستا",1390,"چهارمحال وبختياري",3066,143,2923
"700","9 ساله","دختر","روستا",1390,"چهارمحال وبختياري",2918,163,2755
"701","10 ساله","پسر","شهر",1390,"چهارمحال وبختياري",3975,99,3876
"702","11 ساله","پسر","شهر",1390,"چهارمحال وبختياري",3969,94,3875
"703","12 ساله","پسر","شهر",1390,"چهارمحال وبختياري",3975,116,3859
"704","13 ساله","پسر","شهر",1390,"چهارمحال وبختياري",3976,96,3880
"705","14 ساله","پسر","شهر",1390,"چهارمحال وبختياري",4232,201,4031
"706","15 ساله","پسر","شهر",1390,"چهارمحال وبختياري",4282,314,3968
"707","16 ساله","پسر","شهر",1390,"چهارمحال وبختياري",4500,587,3913
"708","17 ساله","پسر","شهر",1390,"چهارمحال وبختياري",4581,1185,3396
"709","18 ساله","پسر","شهر",1390,"چهارمحال وبختياري",4949,2124,2825
"710","19 ساله","پسر","شهر",1390,"چهارمحال وبختياري",5429,2473,2956
"711","6 ساله","پسر","شهر",1390,"چهارمحال وبختياري",4115,784,3331
"712","7 ساله","پسر","شهر",1390,"چهارمحال وبختياري",3880,127,3753
"713","8 ساله","پسر","شهر",1390,"چهارمحال وبختياري",3801,120,3681
"714","9 ساله","پسر","شهر",1390,"چهارمحال وبختياري",3778,119,3659
"715","10 ساله","دختر","شهر",1390,"چهارمحال وبختياري",3865,82,3783
"716","11 ساله","دختر","شهر",1390,"چهارمحال وبختياري",3842,90,3752
"717","12 ساله","دختر","شهر",1390,"چهارمحال وبختياري",3872,92,3780
"718","13 ساله","دختر","شهر",1390,"چهارمحال وبختياري",3963,123,3840
"719","14 ساله","دختر","شهر",1390,"چهارمحال وبختياري",4113,156,3957
"720","15 ساله","دختر","شهر",1390,"چهارمحال وبختياري",4052,276,3776
"721","16 ساله","دختر","شهر",1390,"چهارمحال وبختياري",4292,476,3816
"722","17 ساله","دختر","شهر",1390,"چهارمحال وبختياري",4572,1101,3471
"723","18 ساله","دختر","شهر",1390,"چهارمحال وبختياري",4810,2173,2637
"724","19 ساله","دختر","شهر",1390,"چهارمحال وبختياري",5439,2426,3013
"725","6 ساله","دختر","شهر",1390,"چهارمحال وبختياري",3949,722,3227
"726","7 ساله","دختر","شهر",1390,"چهارمحال وبختياري",3809,114,3695
"727","8 ساله","دختر","شهر",1390,"چهارمحال وبختياري",3645,108,3537
"728","9 ساله","دختر","شهر",1390,"چهارمحال وبختياري",3703,96,3607
"729","10 ساله","پسر","غیرساکن",1390,"چهارمحال وبختياري",15,10,5
"730","11 ساله","پسر","غیرساکن",1390,"چهارمحال وبختياري",7,5,2
"731","12 ساله","پسر","غیرساکن",1390,"چهارمحال وبختياري",14,11,3
"732","13 ساله","پسر","غیرساکن",1390,"چهارمحال وبختياري",14,13,1
"733","14 ساله","پسر","غیرساکن",1390,"چهارمحال وبختياري",18,17,1
"734","15 ساله","پسر","غیرساکن",1390,"چهارمحال وبختياري",7,7,0
"735","16 ساله","پسر","غیرساکن",1390,"چهارمحال وبختياري",19,19,0
"736","17 ساله","پسر","غیرساکن",1390,"چهارمحال وبختياري",19,18,1
"737","18 ساله","پسر","غیرساکن",1390,"چهارمحال وبختياري",20,19,1
"738","19 ساله","پسر","غیرساکن",1390,"چهارمحال وبختياري",24,23,1
"739","6 ساله","پسر","غیرساکن",1390,"چهارمحال وبختياري",9,7,2
"740","7 ساله","پسر","غیرساکن",1390,"چهارمحال وبختياري",15,11,4
"741","8 ساله","پسر","غیرساکن",1390,"چهارمحال وبختياري",15,9,6
"742","9 ساله","پسر","غیرساکن",1390,"چهارمحال وبختياري",18,5,13
"743","10 ساله","دختر","غیرساکن",1390,"چهارمحال وبختياري",16,11,5
"744","11 ساله","دختر","غیرساکن",1390,"چهارمحال وبختياري",14,12,2
"745","12 ساله","دختر","غیرساکن",1390,"چهارمحال وبختياري",16,14,2
"746","13 ساله","دختر","غیرساکن",1390,"چهارمحال وبختياري",21,21,0
"747","14 ساله","دختر","غیرساکن",1390,"چهارمحال وبختياري",19,19,0
"748","15 ساله","دختر","غیرساکن",1390,"چهارمحال وبختياري",14,14,0
"749","16 ساله","دختر","غیرساکن",1390,"چهارمحال وبختياري",13,12,1
"750","17 ساله","دختر","غیرساکن",1390,"چهارمحال وبختياري",19,19,0
"751","18 ساله","دختر","غیرساکن",1390,"چهارمحال وبختياري",14,14,0
"752","19 ساله","دختر","غیرساکن",1390,"چهارمحال وبختياري",11,11,0
"753","6 ساله","دختر","غیرساکن",1390,"چهارمحال وبختياري",14,12,2
"754","7 ساله","دختر","غیرساکن",1390,"چهارمحال وبختياري",10,8,2
"755","8 ساله","دختر","غیرساکن",1390,"چهارمحال وبختياري",16,10,6
"756","9 ساله","دختر","غیرساکن",1390,"چهارمحال وبختياري",6,1,5
"757","10 ساله","پسر","روستا",1390,"خراسان جنوبي",2649,111,2538
"758","11 ساله","پسر","روستا",1390,"خراسان جنوبي",2586,120,2466
"759","12 ساله","پسر","روستا",1390,"خراسان جنوبي",2746,229,2517
"760","13 ساله","پسر","روستا",1390,"خراسان جنوبي",2605,284,2321
"761","14 ساله","پسر","روستا",1390,"خراسان جنوبي",2214,380,1834
"762","15 ساله","پسر","روستا",1390,"خراسان جنوبي",2346,604,1742
"763","16 ساله","پسر","روستا",1390,"خراسان جنوبي",2346,823,1523
"764","17 ساله","پسر","روستا",1390,"خراسان جنوبي",2793,1495,1298
"765","18 ساله","پسر","روستا",1390,"خراسان جنوبي",3097,2228,869
"766","19 ساله","پسر","روستا",1390,"خراسان جنوبي",2940,2335,605
"767","6 ساله","پسر","روستا",1390,"خراسان جنوبي",2703,606,2097
"768","7 ساله","پسر","روستا",1390,"خراسان جنوبي",2670,124,2546
"769","8 ساله","پسر","روستا",1390,"خراسان جنوبي",2794,131,2663
"770","9 ساله","پسر","روستا",1390,"خراسان جنوبي",2860,124,2736
"771","10 ساله","دختر","روستا",1390,"خراسان جنوبي",2490,121,2369
"772","11 ساله","دختر","روستا",1390,"خراسان جنوبي",2338,217,2121
"773","12 ساله","دختر","روستا",1390,"خراسان جنوبي",2485,397,2088
"774","13 ساله","دختر","روستا",1390,"خراسان جنوبي",2266,495,1771
"775","14 ساله","دختر","روستا",1390,"خراسان جنوبي",2219,696,1523
"776","15 ساله","دختر","روستا",1390,"خراسان جنوبي",2210,1006,1204
"777","16 ساله","دختر","روستا",1390,"خراسان جنوبي",2110,1076,1034
"778","17 ساله","دختر","روستا",1390,"خراسان جنوبي",2742,1793,949
"779","18 ساله","دختر","روستا",1390,"خراسان جنوبي",2950,2290,660
"780","19 ساله","دختر","روستا",1390,"خراسان جنوبي",2837,2314,523
"781","6 ساله","دختر","روستا",1390,"خراسان جنوبي",2695,570,2125
"782","7 ساله","دختر","روستا",1390,"خراسان جنوبي",2630,112,2518
"783","8 ساله","دختر","روستا",1390,"خراسان جنوبي",2611,131,2480
"784","9 ساله","دختر","روستا",1390,"خراسان جنوبي",2534,119,2415
"785","10 ساله","پسر","شهر",1390,"خراسان جنوبي",3042,72,2970
"786","11 ساله","پسر","شهر",1390,"خراسان جنوبي",3467,78,3389
"787","12 ساله","پسر","شهر",1390,"خراسان جنوبي",3491,121,3370
"788","13 ساله","پسر","شهر",1390,"خراسان جنوبي",3414,138,3276
"789","14 ساله","پسر","شهر",1390,"خراسان جنوبي",3892,168,3724
"790","15 ساله","پسر","شهر",1390,"خراسان جنوبي",3950,285,3665
"791","16 ساله","پسر","شهر",1390,"خراسان جنوبي",4049,458,3591
"792","17 ساله","پسر","شهر",1390,"خراسان جنوبي",3929,977,2952
"793","18 ساله","پسر","شهر",1390,"خراسان جنوبي",4443,2104,2339
"794","19 ساله","پسر","شهر",1390,"خراسان جنوبي",5103,2789,2314
"795","6 ساله","پسر","شهر",1390,"خراسان جنوبي",3226,676,2550
"796","7 ساله","پسر","شهر",1390,"خراسان جنوبي",3095,111,2984
"797","8 ساله","پسر","شهر",1390,"خراسان جنوبي",3143,113,3030
"798","9 ساله","پسر","شهر",1390,"خراسان جنوبي",3252,91,3161
"799","10 ساله","دختر","شهر",1390,"خراسان جنوبي",3025,57,2968
"800","11 ساله","دختر","شهر",1390,"خراسان جنوبي",3521,82,3439
"801","12 ساله","دختر","شهر",1390,"خراسان جنوبي",3671,116,3555
"802","13 ساله","دختر","شهر",1390,"خراسان جنوبي",3459,135,3324
"803","14 ساله","دختر","شهر",1390,"خراسان جنوبي",3744,165,3579
"804","15 ساله","دختر","شهر",1390,"خراسان جنوبي",3490,260,3230
"805","16 ساله","دختر","شهر",1390,"خراسان جنوبي",3573,332,3241
"806","17 ساله","دختر","شهر",1390,"خراسان جنوبي",3739,844,2895
"807","18 ساله","دختر","شهر",1390,"خراسان جنوبي",3586,1463,2123
"808","19 ساله","دختر","شهر",1390,"خراسان جنوبي",3787,1445,2342
"809","6 ساله","دختر","شهر",1390,"خراسان جنوبي",3112,704,2408
"810","7 ساله","دختر","شهر",1390,"خراسان جنوبي",2963,98,2865
"811","8 ساله","دختر","شهر",1390,"خراسان جنوبي",2988,87,2901
"812","9 ساله","دختر","شهر",1390,"خراسان جنوبي",2973,73,2900
"813","10 ساله","پسر","غیرساکن",1390,"خراسان جنوبي",0,0,0
"814","11 ساله","پسر","غیرساکن",1390,"خراسان جنوبي",0,0,0
"815","12 ساله","پسر","غیرساکن",1390,"خراسان جنوبي",1,0,1
"816","13 ساله","پسر","غیرساکن",1390,"خراسان جنوبي",1,0,1
"817","14 ساله","پسر","غیرساکن",1390,"خراسان جنوبي",0,0,0
"818","15 ساله","پسر","غیرساکن",1390,"خراسان جنوبي",0,0,0
"819","16 ساله","پسر","غیرساکن",1390,"خراسان جنوبي",2,1,1
"820","17 ساله","پسر","غیرساکن",1390,"خراسان جنوبي",2,1,1
"821","18 ساله","پسر","غیرساکن",1390,"خراسان جنوبي",0,0,0
"822","19 ساله","پسر","غیرساکن",1390,"خراسان جنوبي",1,0,1
"823","6 ساله","پسر","غیرساکن",1390,"خراسان جنوبي",0,0,0
"824","7 ساله","پسر","غیرساکن",1390,"خراسان جنوبي",1,1,0
"825","8 ساله","پسر","غیرساکن",1390,"خراسان جنوبي",0,0,0
"826","9 ساله","پسر","غیرساکن",1390,"خراسان جنوبي",0,0,0
"827","10 ساله","دختر","غیرساکن",1390,"خراسان جنوبي",1,1,0
"828","11 ساله","دختر","غیرساکن",1390,"خراسان جنوبي",0,0,0
"829","12 ساله","دختر","غیرساکن",1390,"خراسان جنوبي",1,1,0
"830","13 ساله","دختر","غیرساکن",1390,"خراسان جنوبي",1,1,0
"831","14 ساله","دختر","غیرساکن",1390,"خراسان جنوبي",3,2,1
"832","15 ساله","دختر","غیرساکن",1390,"خراسان جنوبي",1,1,0
"833","16 ساله","دختر","غیرساکن",1390,"خراسان جنوبي",1,1,0
"834","17 ساله","دختر","غیرساکن",1390,"خراسان جنوبي",0,0,0
"835","18 ساله","دختر","غیرساکن",1390,"خراسان جنوبي",2,2,0
"836","19 ساله","دختر","غیرساکن",1390,"خراسان جنوبي",0,0,0
"837","6 ساله","دختر","غیرساکن",1390,"خراسان جنوبي",0,0,0
"838","7 ساله","دختر","غیرساکن",1390,"خراسان جنوبي",0,0,0
"839","8 ساله","دختر","غیرساکن",1390,"خراسان جنوبي",0,0,0
"840","9 ساله","دختر","غیرساکن",1390,"خراسان جنوبي",0,0,0
"841","10 ساله","پسر","روستا",1390,"خراسان رضوئ",14419,648,13771
"842","11 ساله","پسر","روستا",1390,"خراسان رضوئ",14662,850,13812
"843","12 ساله","پسر","روستا",1390,"خراسان رضوئ",15210,1334,13876
"844","13 ساله","پسر","روستا",1390,"خراسان رضوئ",14959,1815,13144
"845","14 ساله","پسر","روستا",1390,"خراسان رضوئ",15322,3469,11853
"846","15 ساله","پسر","روستا",1390,"خراسان رضوئ",15211,5426,9785
"847","16 ساله","پسر","روستا",1390,"خراسان رضوئ",16086,7434,8652
"848","17 ساله","پسر","روستا",1390,"خراسان رضوئ",17316,10927,6389
"849","18 ساله","پسر","روستا",1390,"خراسان رضوئ",17525,13342,4183
"850","19 ساله","پسر","روستا",1390,"خراسان رضوئ",14950,12269,2681
"851","6 ساله","پسر","روستا",1390,"خراسان رضوئ",16344,4007,12337
"852","7 ساله","پسر","روستا",1390,"خراسان رضوئ",15575,872,14703
"853","8 ساله","پسر","روستا",1390,"خراسان رضوئ",15134,749,14385
"854","9 ساله","پسر","روستا",1390,"خراسان رضوئ",15056,768,14288
"855","10 ساله","دختر","روستا",1390,"خراسان رضوئ",13927,693,13234
"856","11 ساله","دختر","روستا",1390,"خراسان رضوئ",14056,1461,12595
"857","12 ساله","دختر","روستا",1390,"خراسان رضوئ",14550,2691,11859
"858","13 ساله","دختر","روستا",1390,"خراسان رضوئ",14444,3489,10955
"859","14 ساله","دختر","روستا",1390,"خراسان رضوئ",14411,5680,8731
"860","15 ساله","دختر","روستا",1390,"خراسان رضوئ",14423,7598,6825
"861","16 ساله","دختر","روستا",1390,"خراسان رضوئ",15301,8997,6304
"862","17 ساله","دختر","روستا",1390,"خراسان رضوئ",16620,11830,4790
"863","18 ساله","دختر","روستا",1390,"خراسان رضوئ",17235,14343,2892
"864","19 ساله","دختر","روستا",1390,"خراسان رضوئ",17048,14904,2144
"865","6 ساله","دختر","روستا",1390,"خراسان رضوئ",15510,3834,11676
"866","7 ساله","دختر","روستا",1390,"خراسان رضوئ",14798,807,13991
"867","8 ساله","دختر","روستا",1390,"خراسان رضوئ",14415,732,13683
"868","9 ساله","دختر","روستا",1390,"خراسان رضوئ",14045,676,13369
"869","10 ساله","پسر","شهر",1390,"خراسان رضوئ",35019,1227,33792
"870","11 ساله","پسر","شهر",1390,"خراسان رضوئ",34489,1198,33291
"871","12 ساله","پسر","شهر",1390,"خراسان رضوئ",35694,1554,34140
"872","13 ساله","پسر","شهر",1390,"خراسان رضوئ",34909,2087,32822
"873","14 ساله","پسر","شهر",1390,"خراسان رضوئ",35712,3456,32256
"874","15 ساله","پسر","شهر",1390,"خراسان رضوئ",36425,5861,30564
"875","16 ساله","پسر","شهر",1390,"خراسان رضوئ",37170,8577,28593
"876","17 ساله","پسر","شهر",1390,"خراسان رضوئ",37707,13803,23904
"877","18 ساله","پسر","شهر",1390,"خراسان رضوئ",37906,19343,18563
"878","19 ساله","پسر","شهر",1390,"خراسان رضوئ",36003,19571,16432
"879","6 ساله","پسر","شهر",1390,"خراسان رضوئ",36146,9019,27127
"880","7 ساله","پسر","شهر",1390,"خراسان رضوئ",34615,1633,32982
"881","8 ساله","پسر","شهر",1390,"خراسان رضوئ",33739,1277,32462
"882","9 ساله","پسر","شهر",1390,"خراسان رضوئ",33810,1244,32566
"883","10 ساله","دختر","شهر",1390,"خراسان رضوئ",33654,1193,32461
"884","11 ساله","دختر","شهر",1390,"خراسان رضوئ",34324,1275,33049
"885","12 ساله","دختر","شهر",1390,"خراسان رضوئ",34885,1769,33116
"886","13 ساله","دختر","شهر",1390,"خراسان رضوئ",34274,2325,31949
"887","14 ساله","دختر","شهر",1390,"خراسان رضوئ",35356,3964,31392
"888","15 ساله","دختر","شهر",1390,"خراسان رضوئ",34959,6342,28617
"889","16 ساله","دختر","شهر",1390,"خراسان رضوئ",36270,8377,27893
"890","17 ساله","دختر","شهر",1390,"خراسان رضوئ",37197,13748,23449
"891","18 ساله","دختر","شهر",1390,"خراسان رضوئ",39062,21151,17911
"892","19 ساله","دختر","شهر",1390,"خراسان رضوئ",40661,23092,17569
"893","6 ساله","دختر","شهر",1390,"خراسان رضوئ",34319,8617,25702
"894","7 ساله","دختر","شهر",1390,"خراسان رضوئ",32822,1513,31309
"895","8 ساله","دختر","شهر",1390,"خراسان رضوئ",32324,1220,31104
"896","9 ساله","دختر","شهر",1390,"خراسان رضوئ",32167,1142,31025
"897","10 ساله","پسر","غیرساکن",1390,"خراسان رضوئ",6,6,0
"898","11 ساله","پسر","غیرساکن",1390,"خراسان رضوئ",6,5,1
"899","12 ساله","پسر","غیرساکن",1390,"خراسان رضوئ",9,8,1
"900","13 ساله","پسر","غیرساکن",1390,"خراسان رضوئ",6,5,1
"901","14 ساله","پسر","غیرساکن",1390,"خراسان رضوئ",15,15,0
"902","15 ساله","پسر","غیرساکن",1390,"خراسان رضوئ",6,6,0
"903","16 ساله","پسر","غیرساکن",1390,"خراسان رضوئ",8,8,0
"904","17 ساله","پسر","غیرساکن",1390,"خراسان رضوئ",10,9,1
"905","18 ساله","پسر","غیرساکن",1390,"خراسان رضوئ",10,9,1
"906","19 ساله","پسر","غیرساکن",1390,"خراسان رضوئ",6,6,0
"907","6 ساله","پسر","غیرساکن",1390,"خراسان رضوئ",12,12,0
"908","7 ساله","پسر","غیرساکن",1390,"خراسان رضوئ",10,8,2
"909","8 ساله","پسر","غیرساکن",1390,"خراسان رضوئ",13,11,2
"910","9 ساله","پسر","غیرساکن",1390,"خراسان رضوئ",12,11,1
"911","10 ساله","دختر","غیرساکن",1390,"خراسان رضوئ",7,7,0
"912","11 ساله","دختر","غیرساکن",1390,"خراسان رضوئ",8,8,0
"913","12 ساله","دختر","غیرساکن",1390,"خراسان رضوئ",13,12,1
"914","13 ساله","دختر","غیرساکن",1390,"خراسان رضوئ",12,12,0
"915","14 ساله","دختر","غیرساکن",1390,"خراسان رضوئ",9,9,0
"916","15 ساله","دختر","غیرساکن",1390,"خراسان رضوئ",15,15,0
"917","16 ساله","دختر","غیرساکن",1390,"خراسان رضوئ",12,11,1
"918","17 ساله","دختر","غیرساکن",1390,"خراسان رضوئ",9,9,0
"919","18 ساله","دختر","غیرساکن",1390,"خراسان رضوئ",19,19,0
"920","19 ساله","دختر","غیرساکن",1390,"خراسان رضوئ",8,8,0
"921","6 ساله","دختر","غیرساکن",1390,"خراسان رضوئ",10,8,2
"922","7 ساله","دختر","غیرساکن",1390,"خراسان رضوئ",8,8,0
"923","8 ساله","دختر","غیرساکن",1390,"خراسان رضوئ",8,5,3
"924","9 ساله","دختر","غیرساکن",1390,"خراسان رضوئ",6,6,0
"925","10 ساله","پسر","روستا",1390,"خراسان شمالي",3539,134,3405
"926","11 ساله","پسر","روستا",1390,"خراسان شمالي",3745,190,3555
"927","12 ساله","پسر","روستا",1390,"خراسان شمالي",4031,299,3732
"928","13 ساله","پسر","روستا",1390,"خراسان شمالي",3977,426,3551
"929","14 ساله","پسر","روستا",1390,"خراسان شمالي",4092,801,3291
"930","15 ساله","پسر","روستا",1390,"خراسان شمالي",4170,1383,2787
"931","16 ساله","پسر","روستا",1390,"خراسان شمالي",4290,1774,2516
"932","17 ساله","پسر","روستا",1390,"خراسان شمالي",4446,2630,1816
"933","18 ساله","پسر","روستا",1390,"خراسان شمالي",4704,3480,1224
"934","19 ساله","پسر","روستا",1390,"خراسان شمالي",4442,3534,908
"935","6 ساله","پسر","روستا",1390,"خراسان شمالي",4084,911,3173
"936","7 ساله","پسر","روستا",1390,"خراسان شمالي",3859,165,3694
"937","8 ساله","پسر","روستا",1390,"خراسان شمالي",3726,139,3587
"938","9 ساله","پسر","روستا",1390,"خراسان شمالي",3619,117,3502
"939","10 ساله","دختر","روستا",1390,"خراسان شمالي",3309,139,3170
"940","11 ساله","دختر","روستا",1390,"خراسان شمالي",3653,422,3231
"941","12 ساله","دختر","روستا",1390,"خراسان شمالي",4020,746,3274
"942","13 ساله","دختر","روستا",1390,"خراسان شمالي",4060,982,3078
"943","14 ساله","دختر","روستا",1390,"خراسان شمالي",4003,1558,2445
"944","15 ساله","دختر","روستا",1390,"خراسان شمالي",4027,2026,2001
"945","16 ساله","دختر","روستا",1390,"خراسان شمالي",4261,2397,1864
"946","17 ساله","دختر","روستا",1390,"خراسان شمالي",4509,3005,1504
"947","18 ساله","دختر","روستا",1390,"خراسان شمالي",4662,3731,931
"948","19 ساله","دختر","روستا",1390,"خراسان شمالي",4552,3779,773
"949","6 ساله","دختر","روستا",1390,"خراسان شمالي",3728,800,2928
"950","7 ساله","دختر","روستا",1390,"خراسان شمالي",3685,138,3547
"951","8 ساله","دختر","روستا",1390,"خراسان شمالي",3619,145,3474
"952","9 ساله","دختر","روستا",1390,"خراسان شمالي",3414,130,3284
"953","10 ساله","پسر","شهر",1390,"خراسان شمالي",3273,79,3194
"954","11 ساله","پسر","شهر",1390,"خراسان شمالي",3765,72,3693
"955","12 ساله","پسر","شهر",1390,"خراسان شمالي",4073,79,3994
"956","13 ساله","پسر","شهر",1390,"خراسان شمالي",3890,109,3781
"957","14 ساله","پسر","شهر",1390,"خراسان شمالي",4234,208,4026
"958","15 ساله","پسر","شهر",1390,"خراسان شمالي",4354,390,3964
"959","16 ساله","پسر","شهر",1390,"خراسان شمالي",4686,638,4048
"960","17 ساله","پسر","شهر",1390,"خراسان شمالي",4665,1212,3453
"961","18 ساله","پسر","شهر",1390,"خراسان شمالي",4539,1787,2752
"962","19 ساله","پسر","شهر",1390,"خراسان شمالي",4470,2058,2412
"963","6 ساله","پسر","شهر",1390,"خراسان شمالي",3607,768,2839
"964","7 ساله","پسر","شهر",1390,"خراسان شمالي",3403,98,3305
"965","8 ساله","پسر","شهر",1390,"خراسان شمالي",3329,68,3261
"966","9 ساله","پسر","شهر",1390,"خراسان شمالي",3295,88,3207
"967","10 ساله","دختر","شهر",1390,"خراسان شمالي",3336,89,3247
"968","11 ساله","دختر","شهر",1390,"خراسان شمالي",3610,70,3540
"969","12 ساله","دختر","شهر",1390,"خراسان شمالي",3854,116,3738
"970","13 ساله","دختر","شهر",1390,"خراسان شمالي",3824,149,3675
"971","14 ساله","دختر","شهر",1390,"خراسان شمالي",4176,251,3925
"972","15 ساله","دختر","شهر",1390,"خراسان شمالي",4234,373,3861
"973","16 ساله","دختر","شهر",1390,"خراسان شمالي",4588,578,4010
"974","17 ساله","دختر","شهر",1390,"خراسان شمالي",4644,1163,3481
"975","18 ساله","دختر","شهر",1390,"خراسان شمالي",4491,1946,2545
"976","19 ساله","دختر","شهر",1390,"خراسان شمالي",4533,2115,2418
"977","6 ساله","دختر","شهر",1390,"خراسان شمالي",3506,759,2747
"978","7 ساله","دختر","شهر",1390,"خراسان شمالي",3371,87,3284
"979","8 ساله","دختر","شهر",1390,"خراسان شمالي",3190,73,3117
"980","9 ساله","دختر","شهر",1390,"خراسان شمالي",3246,70,3176
"981","10 ساله","پسر","غیرساکن",1390,"خراسان شمالي",27,0,27
"982","11 ساله","پسر","غیرساکن",1390,"خراسان شمالي",18,4,14
"983","12 ساله","پسر","غیرساکن",1390,"خراسان شمالي",13,1,12
"984","13 ساله","پسر","غیرساکن",1390,"خراسان شمالي",23,10,13
"985","14 ساله","پسر","غیرساکن",1390,"خراسان شمالي",15,7,8
"986","15 ساله","پسر","غیرساکن",1390,"خراسان شمالي",21,13,8
"987","16 ساله","پسر","غیرساکن",1390,"خراسان شمالي",24,20,4
"988","17 ساله","پسر","غیرساکن",1390,"خراسان شمالي",19,16,3
"989","18 ساله","پسر","غیرساکن",1390,"خراسان شمالي",23,19,4
"990","19 ساله","پسر","غیرساکن",1390,"خراسان شمالي",10,10,0
"991","6 ساله","پسر","غیرساکن",1390,"خراسان شمالي",28,9,19
"992","7 ساله","پسر","غیرساکن",1390,"خراسان شمالي",17,0,17
"993","8 ساله","پسر","غیرساکن",1390,"خراسان شمالي",24,3,21
"994","9 ساله","پسر","غیرساکن",1390,"خراسان شمالي",18,0,18
"995","10 ساله","دختر","غیرساکن",1390,"خراسان شمالي",16,6,10
"996","11 ساله","دختر","غیرساکن",1390,"خراسان شمالي",15,8,7
"997","12 ساله","دختر","غیرساکن",1390,"خراسان شمالي",23,17,6
"998","13 ساله","دختر","غیرساکن",1390,"خراسان شمالي",24,19,5
"999","14 ساله","دختر","غیرساکن",1390,"خراسان شمالي",16,13,3
"1000","15 ساله","دختر","غیرساکن",1390,"خراسان شمالي",25,23,2
"1001","16 ساله","دختر","غیرساکن",1390,"خراسان شمالي",25,25,0
"1002","17 ساله","دختر","غیرساکن",1390,"خراسان شمالي",20,18,2
"1003","18 ساله","دختر","غیرساکن",1390,"خراسان شمالي",29,28,1
"1004","19 ساله","دختر","غیرساکن",1390,"خراسان شمالي",22,22,0
"1005","6 ساله","دختر","غیرساکن",1390,"خراسان شمالي",24,12,12
"1006","7 ساله","دختر","غیرساکن",1390,"خراسان شمالي",22,0,22
"1007","8 ساله","دختر","غیرساکن",1390,"خراسان شمالي",15,1,14
"1008","9 ساله","دختر","غیرساکن",1390,"خراسان شمالي",18,2,16
"1009","10 ساله","پسر","روستا",1390,"خوزستان",12357,736,11621
"1010","11 ساله","پسر","روستا",1390,"خوزستان",11926,901,11025
"1011","12 ساله","پسر","روستا",1390,"خوزستان",12805,1273,11532
"1012","13 ساله","پسر","روستا",1390,"خوزستان",12647,1669,10978
"1013","14 ساله","پسر","روستا",1390,"خوزستان",13007,2478,10529
"1014","15 ساله","پسر","روستا",1390,"خوزستان",13696,3438,10258
"1015","16 ساله","پسر","روستا",1390,"خوزستان",15153,5094,10059
"1016","17 ساله","پسر","روستا",1390,"خوزستان",15924,7595,8329
"1017","18 ساله","پسر","روستا",1390,"خوزستان",16740,10391,6349
"1018","19 ساله","پسر","روستا",1390,"خوزستان",17606,12808,4798
"1019","6 ساله","پسر","روستا",1390,"خوزستان",12773,3443,9330
"1020","7 ساله","پسر","روستا",1390,"خوزستان",12458,913,11545
"1021","8 ساله","پسر","روستا",1390,"خوزستان",12812,872,11940
"1022","9 ساله","پسر","روستا",1390,"خوزستان",12580,879,11701
"1023","10 ساله","دختر","روستا",1390,"خوزستان",12023,1067,10956
"1024","11 ساله","دختر","روستا",1390,"خوزستان",11307,1659,9648
"1025","12 ساله","دختر","روستا",1390,"خوزستان",12095,2777,9318
"1026","13 ساله","دختر","روستا",1390,"خوزستان",12277,3485,8792
"1027","14 ساله","دختر","روستا",1390,"خوزستان",12367,4661,7706
"1028","15 ساله","دختر","روستا",1390,"خوزستان",13078,5992,7086
"1029","16 ساله","دختر","روستا",1390,"خوزستان",14313,7401,6912
"1030","17 ساله","دختر","روستا",1390,"خوزستان",14900,9261,5639
"1031","18 ساله","دختر","روستا",1390,"خوزستان",15684,11926,3758
"1032","19 ساله","دختر","روستا",1390,"خوزستان",15206,12217,2989
"1033","6 ساله","دختر","روستا",1390,"خوزستان",12269,3454,8815
"1034","7 ساله","دختر","روستا",1390,"خوزستان",11976,1005,10971
"1035","8 ساله","دختر","روستا",1390,"خوزستان",12212,922,11290
"1036","9 ساله","دختر","روستا",1390,"خوزستان",11978,960,11018
"1037","10 ساله","پسر","شهر",1390,"خوزستان",25558,951,24607
"1038","11 ساله","پسر","شهر",1390,"خوزستان",24704,899,23805
"1039","12 ساله","پسر","شهر",1390,"خوزستان",25638,1069,24569
"1040","13 ساله","پسر","شهر",1390,"خوزستان",25657,1343,24314
"1041","14 ساله","پسر","شهر",1390,"خوزستان",25538,2011,23527
"1042","15 ساله","پسر","شهر",1390,"خوزستان",26578,3322,23256
"1043","16 ساله","پسر","شهر",1390,"خوزستان",29541,5375,24166
"1044","17 ساله","پسر","شهر",1390,"خوزستان",31232,9818,21414
"1045","18 ساله","پسر","شهر",1390,"خوزستان",33095,15218,17877
"1046","19 ساله","پسر","شهر",1390,"خوزستان",33677,17462,16215
"1047","6 ساله","پسر","شهر",1390,"خوزستان",26578,6211,20367
"1048","7 ساله","پسر","شهر",1390,"خوزستان",25205,1200,24005
"1049","8 ساله","پسر","شهر",1390,"خوزستان",25394,1092,24302
"1050","9 ساله","پسر","شهر",1390,"خوزستان",24913,1011,23902
"1051","10 ساله","دختر","شهر",1390,"خوزستان",24917,956,23961
"1052","11 ساله","دختر","شهر",1390,"خوزستان",24097,1011,23086
"1053","12 ساله","دختر","شهر",1390,"خوزستان",24459,1367,23092
"1054","13 ساله","دختر","شهر",1390,"خوزستان",24851,1814,23037
"1055","14 ساله","دختر","شهر",1390,"خوزستان",24519,2792,21727
"1056","15 ساله","دختر","شهر",1390,"خوزستان",25412,4134,21278
"1057","16 ساله","دختر","شهر",1390,"خوزستان",28571,6426,22145
"1058","17 ساله","دختر","شهر",1390,"خوزستان",30656,10813,19843
"1059","18 ساله","دختر","شهر",1390,"خوزستان",33162,18514,14648
"1060","19 ساله","دختر","شهر",1390,"خوزستان",35366,19699,15667
"1061","6 ساله","دختر","شهر",1390,"خوزستان",25436,6057,19379
"1062","7 ساله","دختر","شهر",1390,"خوزستان",23873,1054,22819
"1063","8 ساله","دختر","شهر",1390,"خوزستان",24384,1012,23372
"1064","9 ساله","دختر","شهر",1390,"خوزستان",23254,895,22359
"1065","10 ساله","پسر","غیرساکن",1390,"خوزستان",145,31,114
"1066","11 ساله","پسر","غیرساکن",1390,"خوزستان",135,36,99
"1067","12 ساله","پسر","غیرساکن",1390,"خوزستان",153,56,97
"1068","13 ساله","پسر","غیرساکن",1390,"خوزستان",162,82,80
"1069","14 ساله","پسر","غیرساکن",1390,"خوزستان",184,93,91
"1070","15 ساله","پسر","غیرساکن",1390,"خوزستان",183,111,72
"1071","16 ساله","پسر","غیرساکن",1390,"خوزستان",172,109,63
"1072","17 ساله","پسر","غیرساکن",1390,"خوزستان",179,139,40
"1073","18 ساله","پسر","غیرساکن",1390,"خوزستان",182,157,25
"1074","19 ساله","پسر","غیرساکن",1390,"خوزستان",143,129,14
"1075","6 ساله","پسر","غیرساکن",1390,"خوزستان",136,60,76
"1076","7 ساله","پسر","غیرساکن",1390,"خوزستان",155,31,124
"1077","8 ساله","پسر","غیرساکن",1390,"خوزستان",137,20,117
"1078","9 ساله","پسر","غیرساکن",1390,"خوزستان",150,23,127
"1079","10 ساله","دختر","غیرساکن",1390,"خوزستان",121,37,84
"1080","11 ساله","دختر","غیرساکن",1390,"خوزستان",139,59,80
"1081","12 ساله","دختر","غیرساکن",1390,"خوزستان",131,72,59
"1082","13 ساله","دختر","غیرساکن",1390,"خوزستان",138,88,50
"1083","14 ساله","دختر","غیرساکن",1390,"خوزستان",161,127,34
"1084","15 ساله","دختر","غیرساکن",1390,"خوزستان",173,144,29
"1085","16 ساله","دختر","غیرساکن",1390,"خوزستان",175,150,25
"1086","17 ساله","دختر","غیرساکن",1390,"خوزستان",149,135,14
"1087","18 ساله","دختر","غیرساکن",1390,"خوزستان",168,157,11
"1088","19 ساله","دختر","غیرساکن",1390,"خوزستان",120,116,4
"1089","6 ساله","دختر","غیرساکن",1390,"خوزستان",114,48,66
"1090","7 ساله","دختر","غیرساکن",1390,"خوزستان",124,32,92
"1091","8 ساله","دختر","غیرساکن",1390,"خوزستان",152,32,120
"1092","9 ساله","دختر","غیرساکن",1390,"خوزستان",144,22,122
"1093","10 ساله","پسر","روستا",1390,"زنجان",2863,115,2748
"1094","11 ساله","پسر","روستا",1390,"زنجان",2745,175,2570
"1095","12 ساله","پسر","روستا",1390,"زنجان",2900,214,2686
"1096","13 ساله","پسر","روستا",1390,"زنجان",2985,269,2716
"1097","14 ساله","پسر","روستا",1390,"زنجان",3338,485,2853
"1098","15 ساله","پسر","روستا",1390,"زنجان",3356,905,2451
"1099","16 ساله","پسر","روستا",1390,"زنجان",3804,1327,2477
"1100","17 ساله","پسر","روستا",1390,"زنجان",4292,2319,1973
"1101","18 ساله","پسر","روستا",1390,"زنجان",4495,3162,1333
"1102","19 ساله","پسر","روستا",1390,"زنجان",3781,2858,923
"1103","6 ساله","پسر","روستا",1390,"زنجان",3042,599,2443
"1104","7 ساله","پسر","روستا",1390,"زنجان",2836,154,2682
"1105","8 ساله","پسر","روستا",1390,"زنجان",2947,157,2790
"1106","9 ساله","پسر","روستا",1390,"زنجان",3001,156,2845
"1107","10 ساله","دختر","روستا",1390,"زنجان",2907,157,2750
"1108","11 ساله","دختر","روستا",1390,"زنجان",2621,276,2345
"1109","12 ساله","دختر","روستا",1390,"زنجان",2677,481,2196
"1110","13 ساله","دختر","روستا",1390,"زنجان",2797,655,2142
"1111","14 ساله","دختر","روستا",1390,"زنجان",3208,1264,1944
"1112","15 ساله","دختر","روستا",1390,"زنجان",3306,1718,1588
"1113","16 ساله","دختر","روستا",1390,"زنجان",3869,2324,1545
"1114","17 ساله","دختر","روستا",1390,"زنجان",4138,2891,1247
"1115","18 ساله","دختر","روستا",1390,"زنجان",4355,3618,737
"1116","19 ساله","دختر","روستا",1390,"زنجان",4640,3891,749
"1117","6 ساله","دختر","روستا",1390,"زنجان",2872,620,2252
"1118","7 ساله","دختر","روستا",1390,"زنجان",2728,160,2568
"1119","8 ساله","دختر","روستا",1390,"زنجان",2758,160,2598
"1120","9 ساله","دختر","روستا",1390,"زنجان",2756,155,2601
"1121","10 ساله","پسر","شهر",1390,"زنجان",4749,84,4665
"1122","11 ساله","پسر","شهر",1390,"زنجان",4536,74,4462
"1123","12 ساله","پسر","شهر",1390,"زنجان",4468,91,4377
"1124","13 ساله","پسر","شهر",1390,"زنجان",4550,83,4467
"1125","14 ساله","پسر","شهر",1390,"زنجان",4837,133,4704
"1126","15 ساله","پسر","شهر",1390,"زنجان",5119,314,4805
"1127","16 ساله","پسر","شهر",1390,"زنجان",5430,525,4905
"1128","17 ساله","پسر","شهر",1390,"زنجان",5756,1368,4388
"1129","18 ساله","پسر","شهر",1390,"زنجان",5961,2247,3714
"1130","19 ساله","پسر","شهر",1390,"زنجان",6544,3033,3511
"1131","6 ساله","پسر","شهر",1390,"زنجان",4480,802,3678
"1132","7 ساله","پسر","شهر",1390,"زنجان",4176,120,4056
"1133","8 ساله","پسر","شهر",1390,"زنجان",4332,89,4243
"1134","9 ساله","پسر","شهر",1390,"زنجان",4379,92,4287
"1135","10 ساله","دختر","شهر",1390,"زنجان",4598,100,4498
"1136","11 ساله","دختر","شهر",1390,"زنجان",4278,71,4207
"1137","12 ساله","دختر","شهر",1390,"زنجان",4389,85,4304
"1138","13 ساله","دختر","شهر",1390,"زنجان",4324,86,4238
"1139","14 ساله","دختر","شهر",1390,"زنجان",4740,201,4539
"1140","15 ساله","دختر","شهر",1390,"زنجان",4615,401,4214
"1141","16 ساله","دختر","شهر",1390,"زنجان",4997,699,4298
"1142","17 ساله","دختر","شهر",1390,"زنجان",5470,1440,4030
"1143","18 ساله","دختر","شهر",1390,"زنجان",5743,2656,3087
"1144","19 ساله","دختر","شهر",1390,"زنجان",6498,2987,3511
"1145","6 ساله","دختر","شهر",1390,"زنجان",4354,827,3527
"1146","7 ساله","دختر","شهر",1390,"زنجان",4063,94,3969
"1147","8 ساله","دختر","شهر",1390,"زنجان",4173,81,4092
"1148","9 ساله","دختر","شهر",1390,"زنجان",3921,72,3849
"1149","10 ساله","پسر","غیرساکن",1390,"زنجان",0,0,0
"1150","11 ساله","پسر","غیرساکن",1390,"زنجان",0,0,0
"1151","12 ساله","پسر","غیرساکن",1390,"زنجان",0,0,0
"1152","13 ساله","پسر","غیرساکن",1390,"زنجان",0,0,0
"1153","14 ساله","پسر","غیرساکن",1390,"زنجان",0,0,0
"1154","15 ساله","پسر","غیرساکن",1390,"زنجان",0,0,0
"1155","16 ساله","پسر","غیرساکن",1390,"زنجان",0,0,0
"1156","17 ساله","پسر","غیرساکن",1390,"زنجان",0,0,0
"1157","18 ساله","پسر","غیرساکن",1390,"زنجان",0,0,0
"1158","19 ساله","پسر","غیرساکن",1390,"زنجان",0,0,0
"1159","6 ساله","پسر","غیرساکن",1390,"زنجان",0,0,0
"1160","7 ساله","پسر","غیرساکن",1390,"زنجان",0,0,0
"1161","8 ساله","پسر","غیرساکن",1390,"زنجان",0,0,0
"1162","9 ساله","پسر","غیرساکن",1390,"زنجان",0,0,0
"1163","10 ساله","دختر","غیرساکن",1390,"زنجان",0,0,0
"1164","11 ساله","دختر","غیرساکن",1390,"زنجان",0,0,0
"1165","12 ساله","دختر","غیرساکن",1390,"زنجان",0,0,0
"1166","13 ساله","دختر","غیرساکن",1390,"زنجان",0,0,0
"1167","14 ساله","دختر","غیرساکن",1390,"زنجان",0,0,0
"1168","15 ساله","دختر","غیرساکن",1390,"زنجان",0,0,0
"1169","16 ساله","دختر","غیرساکن",1390,"زنجان",0,0,0
"1170","17 ساله","دختر","غیرساکن",1390,"زنجان",0,0,0
"1171","18 ساله","دختر","غیرساکن",1390,"زنجان",0,0,0
"1172","19 ساله","دختر","غیرساکن",1390,"زنجان",0,0,0
"1173","6 ساله","دختر","غیرساکن",1390,"زنجان",0,0,0
"1174","7 ساله","دختر","غیرساکن",1390,"زنجان",0,0,0
"1175","8 ساله","دختر","غیرساکن",1390,"زنجان",0,0,0
"1176","9 ساله","دختر","غیرساکن",1390,"زنجان",0,0,0
"1177","10 ساله","پسر","روستا",1390,"سمنان",1033,67,966
"1178","11 ساله","پسر","روستا",1390,"سمنان",1024,56,968
"1179","12 ساله","پسر","روستا",1390,"سمنان",1048,89,959
"1180","13 ساله","پسر","روستا",1390,"سمنان",1077,98,979
"1181","14 ساله","پسر","روستا",1390,"سمنان",1024,144,880
"1182","15 ساله","پسر","روستا",1390,"سمنان",1024,195,829
"1183","16 ساله","پسر","روستا",1390,"سمنان",1117,299,818
"1184","17 ساله","پسر","روستا",1390,"سمنان",1306,600,706
"1185","18 ساله","پسر","روستا",1390,"سمنان",1822,1266,556
"1186","19 ساله","پسر","روستا",1390,"سمنان",2227,1814,413
"1187","6 ساله","پسر","روستا",1390,"سمنان",1113,383,730
"1188","7 ساله","پسر","روستا",1390,"سمنان",1065,80,985
"1189","8 ساله","پسر","روستا",1390,"سمنان",1020,62,958
"1190","9 ساله","پسر","روستا",1390,"سمنان",1020,59,961
"1191","10 ساله","دختر","روستا",1390,"سمنان",955,63,892
"1192","11 ساله","دختر","روستا",1390,"سمنان",964,83,881
"1193","12 ساله","دختر","روستا",1390,"سمنان",964,93,871
"1194","13 ساله","دختر","روستا",1390,"سمنان",1092,119,973
"1195","14 ساله","دختر","روستا",1390,"سمنان",1032,175,857
"1196","15 ساله","دختر","روستا",1390,"سمنان",982,231,751
"1197","16 ساله","دختر","روستا",1390,"سمنان",1123,359,764
"1198","17 ساله","دختر","روستا",1390,"سمنان",1234,599,635
"1199","18 ساله","دختر","روستا",1390,"سمنان",1263,820,443
"1200","19 ساله","دختر","روستا",1390,"سمنان",1253,872,381
"1201","6 ساله","دختر","روستا",1390,"سمنان",1128,359,769
"1202","7 ساله","دختر","روستا",1390,"سمنان",962,92,870
"1203","8 ساله","دختر","روستا",1390,"سمنان",947,65,882
"1204","9 ساله","دختر","روستا",1390,"سمنان",953,69,884
"1205","10 ساله","پسر","شهر",1390,"سمنان",3523,155,3368
"1206","11 ساله","پسر","شهر",1390,"سمنان",3654,176,3478
"1207","12 ساله","پسر","شهر",1390,"سمنان",3482,162,3320
"1208","13 ساله","پسر","شهر",1390,"سمنان",3340,183,3157
"1209","14 ساله","پسر","شهر",1390,"سمنان",3382,228,3154
"1210","15 ساله","پسر","شهر",1390,"سمنان",3320,360,2960
"1211","16 ساله","پسر","شهر",1390,"سمنان",3521,500,3021
"1212","17 ساله","پسر","شهر",1390,"سمنان",3702,956,2746
"1213","18 ساله","پسر","شهر",1390,"سمنان",4777,1432,3345
"1214","19 ساله","پسر","شهر",1390,"سمنان",5081,2028,3053
"1215","6 ساله","پسر","شهر",1390,"سمنان",3520,909,2611
"1216","7 ساله","پسر","شهر",1390,"سمنان",3460,186,3274
"1217","8 ساله","پسر","شهر",1390,"سمنان",3435,145,3290
"1218","9 ساله","پسر","شهر",1390,"سمنان",3428,167,3261
"1219","10 ساله","دختر","شهر",1390,"سمنان",3399,192,3207
"1220","11 ساله","دختر","شهر",1390,"سمنان",3374,175,3199
"1221","12 ساله","دختر","شهر",1390,"سمنان",3419,162,3257
"1222","13 ساله","دختر","شهر",1390,"سمنان",3243,196,3047
"1223","14 ساله","دختر","شهر",1390,"سمنان",3304,200,3104
"1224","15 ساله","دختر","شهر",1390,"سمنان",3296,382,2914
"1225","16 ساله","دختر","شهر",1390,"سمنان",3440,468,2972
"1226","17 ساله","دختر","شهر",1390,"سمنان",3594,860,2734
"1227","18 ساله","دختر","شهر",1390,"سمنان",4563,1535,3028
"1228","19 ساله","دختر","شهر",1390,"سمنان",5439,1678,3761
"1229","6 ساله","دختر","شهر",1390,"سمنان",3420,869,2551
"1230","7 ساله","دختر","شهر",1390,"سمنان",3152,172,2980
"1231","8 ساله","دختر","شهر",1390,"سمنان",3196,138,3058
"1232","9 ساله","دختر","شهر",1390,"سمنان",3276,139,3137
"1233","10 ساله","پسر","غیرساکن",1390,"سمنان",0,0,0
"1234","11 ساله","پسر","غیرساکن",1390,"سمنان",0,0,0
"1235","12 ساله","پسر","غیرساکن",1390,"سمنان",0,0,0
"1236","13 ساله","پسر","غیرساکن",1390,"سمنان",0,0,0
"1237","14 ساله","پسر","غیرساکن",1390,"سمنان",0,0,0
"1238","15 ساله","پسر","غیرساکن",1390,"سمنان",0,0,0
"1239","16 ساله","پسر","غیرساکن",1390,"سمنان",0,0,0
"1240","17 ساله","پسر","غیرساکن",1390,"سمنان",0,0,0
"1241","18 ساله","پسر","غیرساکن",1390,"سمنان",0,0,0
"1242","19 ساله","پسر","غیرساکن",1390,"سمنان",0,0,0
"1243","6 ساله","پسر","غیرساکن",1390,"سمنان",0,0,0
"1244","7 ساله","پسر","غیرساکن",1390,"سمنان",0,0,0
"1245","8 ساله","پسر","غیرساکن",1390,"سمنان",0,0,0
"1246","9 ساله","پسر","غیرساکن",1390,"سمنان",0,0,0
"1247","10 ساله","دختر","غیرساکن",1390,"سمنان",0,0,0
"1248","11 ساله","دختر","غیرساکن",1390,"سمنان",0,0,0
"1249","12 ساله","دختر","غیرساکن",1390,"سمنان",0,0,0
"1250","13 ساله","دختر","غیرساکن",1390,"سمنان",0,0,0
"1251","14 ساله","دختر","غیرساکن",1390,"سمنان",0,0,0
"1252","15 ساله","دختر","غیرساکن",1390,"سمنان",0,0,0
"1253","16 ساله","دختر","غیرساکن",1390,"سمنان",0,0,0
"1254","17 ساله","دختر","غیرساکن",1390,"سمنان",0,0,0
"1255","18 ساله","دختر","غیرساکن",1390,"سمنان",0,0,0
"1256","19 ساله","دختر","غیرساکن",1390,"سمنان",0,0,0
"1257","6 ساله","دختر","غیرساکن",1390,"سمنان",0,0,0
"1258","7 ساله","دختر","غیرساکن",1390,"سمنان",0,0,0
"1259","8 ساله","دختر","غیرساکن",1390,"سمنان",0,0,0
"1260","9 ساله","دختر","غیرساکن",1390,"سمنان",0,0,0
"1261","10 ساله","پسر","روستا",1390,"سيستان وبلوچستان",13938,2194,11744
"1262","11 ساله","پسر","روستا",1390,"سيستان وبلوچستان",14417,2424,11993
"1263","12 ساله","پسر","روستا",1390,"سيستان وبلوچستان",15325,3407,11918
"1264","13 ساله","پسر","روستا",1390,"سيستان وبلوچستان",15528,3946,11582
"1265","14 ساله","پسر","روستا",1390,"سيستان وبلوچستان",15552,4906,10646
"1266","15 ساله","پسر","روستا",1390,"سيستان وبلوچستان",14749,5714,9035
"1267","16 ساله","پسر","روستا",1390,"سيستان وبلوچستان",14279,6377,7902
"1268","17 ساله","پسر","روستا",1390,"سيستان وبلوچستان",14655,8240,6415
"1269","18 ساله","پسر","روستا",1390,"سيستان وبلوچستان",14921,10498,4423
"1270","19 ساله","پسر","روستا",1390,"سيستان وبلوچستان",13976,11135,2841
"1271","6 ساله","پسر","روستا",1390,"سيستان وبلوچستان",17509,6714,10795
"1272","7 ساله","پسر","روستا",1390,"سيستان وبلوچستان",16719,2694,14025
"1273","8 ساله","پسر","روستا",1390,"سيستان وبلوچستان",15866,2483,13383
"1274","9 ساله","پسر","روستا",1390,"سيستان وبلوچستان",15828,2222,13606
"1275","10 ساله","دختر","روستا",1390,"سيستان وبلوچستان",13859,2703,11156
"1276","11 ساله","دختر","روستا",1390,"سيستان وبلوچستان",13789,3633,10156
"1277","12 ساله","دختر","روستا",1390,"سيستان وبلوچستان",15121,5610,9511
"1278","13 ساله","دختر","روستا",1390,"سيستان وبلوچستان",15323,7098,8225
"1279","14 ساله","دختر","روستا",1390,"سيستان وبلوچستان",15053,8202,6851
"1280","15 ساله","دختر","روستا",1390,"سيستان وبلوچستان",14411,8938,5473
"1281","16 ساله","دختر","روستا",1390,"سيستان وبلوچستان",14300,9395,4905
"1282","17 ساله","دختر","روستا",1390,"سيستان وبلوچستان",14627,10667,3960
"1283","18 ساله","دختر","روستا",1390,"سيستان وبلوچستان",14670,11972,2698
"1284","19 ساله","دختر","روستا",1390,"سيستان وبلوچستان",13714,11717,1997
"1285","6 ساله","دختر","روستا",1390,"سيستان وبلوچستان",16643,6584,10059
"1286","7 ساله","دختر","روستا",1390,"سيستان وبلوچستان",16078,2842,13236
"1287","8 ساله","دختر","روستا",1390,"سيستان وبلوچستان",15591,2662,12929
"1288","9 ساله","دختر","روستا",1390,"سيستان وبلوچستان",15392,2545,12847
"1289","10 ساله","پسر","شهر",1390,"سيستان وبلوچستان",13301,1114,12187
"1290","11 ساله","پسر","شهر",1390,"سيستان وبلوچستان",12844,1130,11714
"1291","12 ساله","پسر","شهر",1390,"سيستان وبلوچستان",13474,1520,11954
"1292","13 ساله","پسر","شهر",1390,"سيستان وبلوچستان",13293,1764,11529
"1293","14 ساله","پسر","شهر",1390,"سيستان وبلوچستان",13286,2286,11000
"1294","15 ساله","پسر","شهر",1390,"سيستان وبلوچستان",12908,3145,9763
"1295","16 ساله","پسر","شهر",1390,"سيستان وبلوچستان",13200,3808,9392
"1296","17 ساله","پسر","شهر",1390,"سيستان وبلوچستان",13550,5615,7935
"1297","18 ساله","پسر","شهر",1390,"سيستان وبلوچستان",13773,7709,6064
"1298","19 ساله","پسر","شهر",1390,"سيستان وبلوچستان",14355,9242,5113
"1299","6 ساله","پسر","شهر",1390,"سيستان وبلوچستان",15132,4544,10588
"1300","7 ساله","پسر","شهر",1390,"سيستان وبلوچستان",14757,1362,13395
"1301","8 ساله","پسر","شهر",1390,"سيستان وبلوچستان",14429,1237,13192
"1302","9 ساله","پسر","شهر",1390,"سيستان وبلوچستان",14452,1229,13223
"1303","10 ساله","دختر","شهر",1390,"سيستان وبلوچستان",12480,1091,11389
"1304","11 ساله","دختر","شهر",1390,"سيستان وبلوچستان",12579,1543,11036
"1305","12 ساله","دختر","شهر",1390,"سيستان وبلوچستان",12650,2189,10461
"1306","13 ساله","دختر","شهر",1390,"سيستان وبلوچستان",12532,2646,9886
"1307","14 ساله","دختر","شهر",1390,"سيستان وبلوچستان",12055,3400,8655
"1308","15 ساله","دختر","شهر",1390,"سيستان وبلوچستان",11718,4161,7557
"1309","16 ساله","دختر","شهر",1390,"سيستان وبلوچستان",12571,5044,7527
"1310","17 ساله","دختر","شهر",1390,"سيستان وبلوچستان",13039,6515,6524
"1311","18 ساله","دختر","شهر",1390,"سيستان وبلوچستان",13675,8739,4936
"1312","19 ساله","دختر","شهر",1390,"سيستان وبلوچستان",13915,9088,4827
"1313","6 ساله","دختر","شهر",1390,"سيستان وبلوچستان",14343,4282,10061
"1314","7 ساله","دختر","شهر",1390,"سيستان وبلوچستان",13974,1361,12613
"1315","8 ساله","دختر","شهر",1390,"سيستان وبلوچستان",13606,1179,12427
"1316","9 ساله","دختر","شهر",1390,"سيستان وبلوچستان",13471,1235,12236
"1317","10 ساله","پسر","غیرساکن",1390,"سيستان وبلوچستان",43,24,19
"1318","11 ساله","پسر","غیرساکن",1390,"سيستان وبلوچستان",46,30,16
"1319","12 ساله","پسر","غیرساکن",1390,"سيستان وبلوچستان",58,38,20
"1320","13 ساله","پسر","غیرساکن",1390,"سيستان وبلوچستان",47,29,18
"1321","14 ساله","پسر","غیرساکن",1390,"سيستان وبلوچستان",40,27,13
"1322","15 ساله","پسر","غیرساکن",1390,"سيستان وبلوچستان",31,22,9
"1323","16 ساله","پسر","غیرساکن",1390,"سيستان وبلوچستان",46,36,10
"1324","17 ساله","پسر","غیرساکن",1390,"سيستان وبلوچستان",43,33,10
"1325","18 ساله","پسر","غیرساکن",1390,"سيستان وبلوچستان",35,33,2
"1326","19 ساله","پسر","غیرساکن",1390,"سيستان وبلوچستان",35,32,3
"1327","6 ساله","پسر","غیرساکن",1390,"سيستان وبلوچستان",57,45,12
"1328","7 ساله","پسر","غیرساکن",1390,"سيستان وبلوچستان",39,20,19
"1329","8 ساله","پسر","غیرساکن",1390,"سيستان وبلوچستان",34,19,15
"1330","9 ساله","پسر","غیرساکن",1390,"سيستان وبلوچستان",35,23,12
"1331","10 ساله","دختر","غیرساکن",1390,"سيستان وبلوچستان",47,28,19
"1332","11 ساله","دختر","غیرساکن",1390,"سيستان وبلوچستان",34,24,10
"1333","12 ساله","دختر","غیرساکن",1390,"سيستان وبلوچستان",42,37,5
"1334","13 ساله","دختر","غیرساکن",1390,"سيستان وبلوچستان",60,48,12
"1335","14 ساله","دختر","غیرساکن",1390,"سيستان وبلوچستان",34,32,2
"1336","15 ساله","دختر","غیرساکن",1390,"سيستان وبلوچستان",43,41,2
"1337","16 ساله","دختر","غیرساکن",1390,"سيستان وبلوچستان",31,29,2
"1338","17 ساله","دختر","غیرساکن",1390,"سيستان وبلوچستان",32,30,2
"1339","18 ساله","دختر","غیرساکن",1390,"سيستان وبلوچستان",47,45,2
"1340","19 ساله","دختر","غیرساکن",1390,"سيستان وبلوچستان",25,25,0
"1341","6 ساله","دختر","غیرساکن",1390,"سيستان وبلوچستان",52,41,11
"1342","7 ساله","دختر","غیرساکن",1390,"سيستان وبلوچستان",41,23,18
"1343","8 ساله","دختر","غیرساکن",1390,"سيستان وبلوچستان",39,26,13
"1344","9 ساله","دختر","غیرساکن",1390,"سيستان وبلوچستان",40,30,10
"1345","10 ساله","پسر","روستا",1390,"فارس",11122,447,10675
"1346","11 ساله","پسر","روستا",1390,"فارس",10932,435,10497
"1347","12 ساله","پسر","روستا",1390,"فارس",11083,539,10544
"1348","13 ساله","پسر","روستا",1390,"فارس",10774,725,10049
"1349","14 ساله","پسر","روستا",1390,"فارس",10569,1132,9437
"1350","15 ساله","پسر","روستا",1390,"فارس",11477,1954,9523
"1351","16 ساله","پسر","روستا",1390,"فارس",12728,3005,9723
"1352","17 ساله","پسر","روستا",1390,"فارس",13570,5695,7875
"1353","18 ساله","پسر","روستا",1390,"فارس",14923,9115,5808
"1354","19 ساله","پسر","روستا",1390,"فارس",15595,10772,4823
"1355","6 ساله","پسر","روستا",1390,"فارس",12189,2908,9281
"1356","7 ساله","پسر","روستا",1390,"فارس",11580,592,10988
"1357","8 ساله","پسر","روستا",1390,"فارس",11412,515,10897
"1358","9 ساله","پسر","روستا",1390,"فارس",11139,512,10627
"1359","10 ساله","دختر","روستا",1390,"فارس",10705,442,10263
"1360","11 ساله","دختر","روستا",1390,"فارس",10421,513,9908
"1361","12 ساله","دختر","روستا",1390,"فارس",10737,706,10031
"1362","13 ساله","دختر","روستا",1390,"فارس",10285,904,9381
"1363","14 ساله","دختر","روستا",1390,"فارس",10335,1498,8837
"1364","15 ساله","دختر","روستا",1390,"فارس",10990,2442,8548
"1365","16 ساله","دختر","روستا",1390,"فارس",12306,3553,8753
"1366","17 ساله","دختر","روستا",1390,"فارس",13404,5664,7740
"1367","18 ساله","دختر","روستا",1390,"فارس",14171,9542,4629
"1368","19 ساله","دختر","روستا",1390,"فارس",15397,11335,4062
"1369","6 ساله","دختر","روستا",1390,"فارس",11466,2600,8866
"1370","7 ساله","دختر","روستا",1390,"فارس",10806,519,10287
"1371","8 ساله","دختر","روستا",1390,"فارس",10925,458,10467
"1372","9 ساله","دختر","روستا",1390,"فارس",10398,418,9980
"1373","10 ساله","پسر","شهر",1390,"فارس",22700,1004,21696
"1374","11 ساله","پسر","شهر",1390,"فارس",22114,946,21168
"1375","12 ساله","پسر","شهر",1390,"فارس",23168,1075,22093
"1376","13 ساله","پسر","شهر",1390,"فارس",22447,1244,21203
"1377","14 ساله","پسر","شهر",1390,"فارس",23065,1655,21410
"1378","15 ساله","پسر","شهر",1390,"فارس",23871,2681,21190
"1379","16 ساله","پسر","شهر",1390,"فارس",25578,3928,21650
"1380","17 ساله","پسر","شهر",1390,"فارس",26576,7630,18946
"1381","18 ساله","پسر","شهر",1390,"فارس",28344,12662,15682
"1382","19 ساله","پسر","شهر",1390,"فارس",30408,15088,15320
"1383","6 ساله","پسر","شهر",1390,"فارس",22385,5354,17031
"1384","7 ساله","پسر","شهر",1390,"فارس",20612,1249,19363
"1385","8 ساله","پسر","شهر",1390,"فارس",21029,1080,19949
"1386","9 ساله","پسر","شهر",1390,"فارس",20682,936,19746
"1387","10 ساله","دختر","شهر",1390,"فارس",21712,1074,20638
"1388","11 ساله","دختر","شهر",1390,"فارس",21876,982,20894
"1389","12 ساله","دختر","شهر",1390,"فارس",22537,1194,21343
"1390","13 ساله","دختر","شهر",1390,"فارس",21692,1236,20456
"1391","14 ساله","دختر","شهر",1390,"فارس",21993,1569,20424
"1392","15 ساله","دختر","شهر",1390,"فارس",22567,2519,20048
"1393","16 ساله","دختر","شهر",1390,"فارس",24357,3380,20977
"1394","17 ساله","دختر","شهر",1390,"فارس",25687,6296,19391
"1395","18 ساله","دختر","شهر",1390,"فارس",26889,12898,13991
"1396","19 ساله","دختر","شهر",1390,"فارس",30631,14130,16501
"1397","6 ساله","دختر","شهر",1390,"فارس",21039,5045,15994
"1398","7 ساله","دختر","شهر",1390,"فارس",19801,1219,18582
"1399","8 ساله","دختر","شهر",1390,"فارس",19789,1047,18742
"1400","9 ساله","دختر","شهر",1390,"فارس",19418,876,18542
"1401","10 ساله","پسر","غیرساکن",1390,"فارس",117,17,100
"1402","11 ساله","پسر","غیرساکن",1390,"فارس",91,17,74
"1403","12 ساله","پسر","غیرساکن",1390,"فارس",97,24,73
"1404","13 ساله","پسر","غیرساکن",1390,"فارس",103,42,61
"1405","14 ساله","پسر","غیرساکن",1390,"فارس",94,51,43
"1406","15 ساله","پسر","غیرساکن",1390,"فارس",152,98,54
"1407","16 ساله","پسر","غیرساکن",1390,"فارس",140,89,51
"1408","17 ساله","پسر","غیرساکن",1390,"فارس",163,121,42
"1409","18 ساله","پسر","غیرساکن",1390,"فارس",179,144,35
"1410","19 ساله","پسر","غیرساکن",1390,"فارس",166,136,30
"1411","6 ساله","پسر","غیرساکن",1390,"فارس",118,30,88
"1412","7 ساله","پسر","غیرساکن",1390,"فارس",150,17,133
"1413","8 ساله","پسر","غیرساکن",1390,"فارس",134,8,126
"1414","9 ساله","پسر","غیرساکن",1390,"فارس",144,13,131
"1415","10 ساله","دختر","غیرساکن",1390,"فارس",142,14,128
"1416","11 ساله","دختر","غیرساکن",1390,"فارس",95,27,68
"1417","12 ساله","دختر","غیرساکن",1390,"فارس",96,42,54
"1418","13 ساله","دختر","غیرساکن",1390,"فارس",103,70,33
"1419","14 ساله","دختر","غیرساکن",1390,"فارس",104,64,40
"1420","15 ساله","دختر","غیرساکن",1390,"فارس",138,99,39
"1421","16 ساله","دختر","غیرساکن",1390,"فارس",153,124,29
"1422","17 ساله","دختر","غیرساکن",1390,"فارس",153,140,13
"1423","18 ساله","دختر","غیرساکن",1390,"فارس",160,150,10
"1424","19 ساله","دختر","غیرساکن",1390,"فارس",168,153,15
"1425","6 ساله","دختر","غیرساکن",1390,"فارس",141,33,108
"1426","7 ساله","دختر","غیرساکن",1390,"فارس",116,19,97
"1427","8 ساله","دختر","غیرساکن",1390,"فارس",120,8,112
"1428","9 ساله","دختر","غیرساکن",1390,"فارس",141,8,133
"1429","10 ساله","پسر","روستا",1390,"قزوين",2306,131,2175
"1430","11 ساله","پسر","روستا",1390,"قزوين",2364,143,2221
"1431","12 ساله","پسر","روستا",1390,"قزوين",2324,156,2168
"1432","13 ساله","پسر","روستا",1390,"قزوين",2329,210,2119
"1433","14 ساله","پسر","روستا",1390,"قزوين",2562,406,2156
"1434","15 ساله","پسر","روستا",1390,"قزوين",2692,589,2103
"1435","16 ساله","پسر","روستا",1390,"قزوين",3016,960,2056
"1436","17 ساله","پسر","روستا",1390,"قزوين",3129,1585,1544
"1437","18 ساله","پسر","روستا",1390,"قزوين",3694,2528,1166
"1438","19 ساله","پسر","روستا",1390,"قزوين",3559,2694,865
"1439","6 ساله","پسر","روستا",1390,"قزوين",2573,700,1873
"1440","7 ساله","پسر","روستا",1390,"قزوين",2451,180,2271
"1441","8 ساله","پسر","روستا",1390,"قزوين",2367,136,2231
"1442","9 ساله","پسر","روستا",1390,"قزوين",2436,121,2315
"1443","10 ساله","دختر","روستا",1390,"قزوين",2213,111,2102
"1444","11 ساله","دختر","روستا",1390,"قزوين",2174,198,1976
"1445","12 ساله","دختر","روستا",1390,"قزوين",2211,250,1961
"1446","13 ساله","دختر","روستا",1390,"قزوين",2321,397,1924
"1447","14 ساله","دختر","روستا",1390,"قزوين",2369,718,1651
"1448","15 ساله","دختر","روستا",1390,"قزوين",2486,1029,1457
"1449","16 ساله","دختر","روستا",1390,"قزوين",2796,1473,1323
"1450","17 ساله","دختر","روستا",1390,"قزوين",2972,1922,1050
"1451","18 ساله","دختر","روستا",1390,"قزوين",3220,2490,730
"1452","19 ساله","دختر","روستا",1390,"قزوين",3402,2740,662
"1453","6 ساله","دختر","روستا",1390,"قزوين",2428,623,1805
"1454","7 ساله","دختر","روستا",1390,"قزوين",2308,152,2156
"1455","8 ساله","دختر","روستا",1390,"قزوين",2344,144,2200
"1456","9 ساله","دختر","روستا",1390,"قزوين",2191,126,2065
"1457","10 ساله","پسر","شهر",1390,"قزوين",6481,499,5982
"1458","11 ساله","پسر","شهر",1390,"قزوين",6224,442,5782
"1459","12 ساله","پسر","شهر",1390,"قزوين",6309,488,5821
"1460","13 ساله","پسر","شهر",1390,"قزوين",6176,511,5665
"1461","14 ساله","پسر","شهر",1390,"قزوين",6459,604,5855
"1462","15 ساله","پسر","شهر",1390,"قزوين",6598,890,5708
"1463","16 ساله","پسر","شهر",1390,"قزوين",7117,1257,5860
"1464","17 ساله","پسر","شهر",1390,"قزوين",7567,2273,5294
"1465","18 ساله","پسر","شهر",1390,"قزوين",7740,3313,4427
"1466","19 ساله","پسر","شهر",1390,"قزوين",7936,3715,4221
"1467","6 ساله","پسر","شهر",1390,"قزوين",6872,1681,5191
"1468","7 ساله","پسر","شهر",1390,"قزوين",6444,551,5893
"1469","8 ساله","پسر","شهر",1390,"قزوين",6306,522,5784
"1470","9 ساله","پسر","شهر",1390,"قزوين",6337,522,5815
"1471","10 ساله","دختر","شهر",1390,"قزوين",6293,516,5777
"1472","11 ساله","دختر","شهر",1390,"قزوين",5898,474,5424
"1473","12 ساله","دختر","شهر",1390,"قزوين",6055,484,5571
"1474","13 ساله","دختر","شهر",1390,"قزوين",5974,531,5443
"1475","14 ساله","دختر","شهر",1390,"قزوين",6136,671,5465
"1476","15 ساله","دختر","شهر",1390,"قزوين",6331,1083,5248
"1477","16 ساله","دختر","شهر",1390,"قزوين",7006,1519,5487
"1478","17 ساله","دختر","شهر",1390,"قزوين",7468,2618,4850
"1479","18 ساله","دختر","شهر",1390,"قزوين",8030,4140,3890
"1480","19 ساله","دختر","شهر",1390,"قزوين",8558,4508,4050
"1481","6 ساله","دختر","شهر",1390,"قزوين",6410,1544,4866
"1482","7 ساله","دختر","شهر",1390,"قزوين",6060,530,5530
"1483","8 ساله","دختر","شهر",1390,"قزوين",6050,491,5559
"1484","9 ساله","دختر","شهر",1390,"قزوين",5708,440,5268
"1485","10 ساله","پسر","غیرساکن",1390,"قزوين",4,1,3
"1486","11 ساله","پسر","غیرساکن",1390,"قزوين",1,0,1
"1487","12 ساله","پسر","غیرساکن",1390,"قزوين",2,1,1
"1488","13 ساله","پسر","غیرساکن",1390,"قزوين",6,0,6
"1489","14 ساله","پسر","غیرساکن",1390,"قزوين",3,1,2
"1490","15 ساله","پسر","غیرساکن",1390,"قزوين",2,1,1
"1491","16 ساله","پسر","غیرساکن",1390,"قزوين",4,1,3
"1492","17 ساله","پسر","غیرساکن",1390,"قزوين",3,1,2
"1493","18 ساله","پسر","غیرساکن",1390,"قزوين",4,4,0
"1494","19 ساله","پسر","غیرساکن",1390,"قزوين",3,3,0
"1495","6 ساله","پسر","غیرساکن",1390,"قزوين",0,0,0
"1496","7 ساله","پسر","غیرساکن",1390,"قزوين",1,1,0
"1497","8 ساله","پسر","غیرساکن",1390,"قزوين",1,0,1
"1498","9 ساله","پسر","غیرساکن",1390,"قزوين",3,0,3
"1499","10 ساله","دختر","غیرساکن",1390,"قزوين",4,0,4
"1500","11 ساله","دختر","غیرساکن",1390,"قزوين",1,0,1
"1501","12 ساله","دختر","غیرساکن",1390,"قزوين",2,1,1
"1502","13 ساله","دختر","غیرساکن",1390,"قزوين",1,0,1
"1503","14 ساله","دختر","غیرساکن",1390,"قزوين",4,3,1
"1504","15 ساله","دختر","غیرساکن",1390,"قزوين",0,0,0
"1505","16 ساله","دختر","غیرساکن",1390,"قزوين",3,1,2
"1506","17 ساله","دختر","غیرساکن",1390,"قزوين",3,0,3
"1507","18 ساله","دختر","غیرساکن",1390,"قزوين",7,3,4
"1508","19 ساله","دختر","غیرساکن",1390,"قزوين",8,4,4
"1509","6 ساله","دختر","غیرساکن",1390,"قزوين",3,2,1
"1510","7 ساله","دختر","غیرساکن",1390,"قزوين",2,1,1
"1511","8 ساله","دختر","غیرساکن",1390,"قزوين",3,0,3
"1512","9 ساله","دختر","غیرساکن",1390,"قزوين",2,0,2
"1513","10 ساله","پسر","روستا",1390,"قم",450,39,411
"1514","11 ساله","پسر","روستا",1390,"قم",381,29,352
"1515","12 ساله","پسر","روستا",1390,"قم",412,35,377
"1516","13 ساله","پسر","روستا",1390,"قم",373,47,326
"1517","14 ساله","پسر","روستا",1390,"قم",420,84,336
"1518","15 ساله","پسر","روستا",1390,"قم",423,128,295
"1519","16 ساله","پسر","روستا",1390,"قم",472,187,285
"1520","17 ساله","پسر","روستا",1390,"قم",494,246,248
"1521","18 ساله","پسر","روستا",1390,"قم",485,341,144
"1522","19 ساله","پسر","روستا",1390,"قم",588,477,111
"1523","6 ساله","پسر","روستا",1390,"قم",419,114,305
"1524","7 ساله","پسر","روستا",1390,"قم",451,48,403
"1525","8 ساله","پسر","روستا",1390,"قم",366,30,336
"1526","9 ساله","پسر","روستا",1390,"قم",452,26,426
"1527","10 ساله","دختر","روستا",1390,"قم",425,30,395
"1528","11 ساله","دختر","روستا",1390,"قم",382,38,344
"1529","12 ساله","دختر","روستا",1390,"قم",437,53,384
"1530","13 ساله","دختر","روستا",1390,"قم",414,73,341
"1531","14 ساله","دختر","روستا",1390,"قم",393,114,279
"1532","15 ساله","دختر","روستا",1390,"قم",438,158,280
"1533","16 ساله","دختر","روستا",1390,"قم",433,202,231
"1534","17 ساله","دختر","روستا",1390,"قم",425,237,188
"1535","18 ساله","دختر","روستا",1390,"قم",470,334,136
"1536","19 ساله","دختر","روستا",1390,"قم",445,363,82
"1537","6 ساله","دختر","روستا",1390,"قم",394,126,268
"1538","7 ساله","دختر","روستا",1390,"قم",382,30,352
"1539","8 ساله","دختر","روستا",1390,"قم",385,29,356
"1540","9 ساله","دختر","روستا",1390,"قم",322,16,306
"1541","10 ساله","پسر","شهر",1390,"قم",8726,226,8500
"1542","11 ساله","پسر","شهر",1390,"قم",8534,175,8359
"1543","12 ساله","پسر","شهر",1390,"قم",8661,281,8380
"1544","13 ساله","پسر","شهر",1390,"قم",8760,383,8377
"1545","14 ساله","پسر","شهر",1390,"قم",8713,698,8015
"1546","15 ساله","پسر","شهر",1390,"قم",9297,1271,8026
"1547","16 ساله","پسر","شهر",1390,"قم",9249,1998,7251
"1548","17 ساله","پسر","شهر",1390,"قم",9822,3132,6690
"1549","18 ساله","پسر","شهر",1390,"قم",10185,4320,5865
"1550","19 ساله","پسر","شهر",1390,"قم",10161,4899,5262
"1551","6 ساله","پسر","شهر",1390,"قم",9223,2371,6852
"1552","7 ساله","پسر","شهر",1390,"قم",8909,368,8541
"1553","8 ساله","پسر","شهر",1390,"قم",8914,277,8637
"1554","9 ساله","پسر","شهر",1390,"قم",8714,293,8421
"1555","10 ساله","دختر","شهر",1390,"قم",8699,252,8447
"1556","11 ساله","دختر","شهر",1390,"قم",8150,219,7931
"1557","12 ساله","دختر","شهر",1390,"قم",8476,319,8157
"1558","13 ساله","دختر","شهر",1390,"قم",8382,491,7891
"1559","14 ساله","دختر","شهر",1390,"قم",8349,788,7561
"1560","15 ساله","دختر","شهر",1390,"قم",8601,1431,7170
"1561","16 ساله","دختر","شهر",1390,"قم",8897,2008,6889
"1562","17 ساله","دختر","شهر",1390,"قم",9427,3540,5887
"1563","18 ساله","دختر","شهر",1390,"قم",9949,5196,4753
"1564","19 ساله","دختر","شهر",1390,"قم",10526,5953,4573
"1565","6 ساله","دختر","شهر",1390,"قم",8685,2222,6463
"1566","7 ساله","دختر","شهر",1390,"قم",8607,339,8268
"1567","8 ساله","دختر","شهر",1390,"قم",8305,263,8042
"1568","9 ساله","دختر","شهر",1390,"قم",8441,222,8219
"1569","10 ساله","پسر","غیرساکن",1390,"قم",0,0,0
"1570","11 ساله","پسر","غیرساکن",1390,"قم",0,0,0
"1571","12 ساله","پسر","غیرساکن",1390,"قم",0,0,0
"1572","13 ساله","پسر","غیرساکن",1390,"قم",0,0,0
"1573","14 ساله","پسر","غیرساکن",1390,"قم",0,0,0
"1574","15 ساله","پسر","غیرساکن",1390,"قم",0,0,0
"1575","16 ساله","پسر","غیرساکن",1390,"قم",0,0,0
"1576","17 ساله","پسر","غیرساکن",1390,"قم",0,0,0
"1577","18 ساله","پسر","غیرساکن",1390,"قم",0,0,0
"1578","19 ساله","پسر","غیرساکن",1390,"قم",0,0,0
"1579","6 ساله","پسر","غیرساکن",1390,"قم",0,0,0
"1580","7 ساله","پسر","غیرساکن",1390,"قم",0,0,0
"1581","8 ساله","پسر","غیرساکن",1390,"قم",0,0,0
"1582","9 ساله","پسر","غیرساکن",1390,"قم",0,0,0
"1583","10 ساله","دختر","غیرساکن",1390,"قم",0,0,0
"1584","11 ساله","دختر","غیرساکن",1390,"قم",0,0,0
"1585","12 ساله","دختر","غیرساکن",1390,"قم",0,0,0
"1586","13 ساله","دختر","غیرساکن",1390,"قم",0,0,0
"1587","14 ساله","دختر","غیرساکن",1390,"قم",0,0,0
"1588","15 ساله","دختر","غیرساکن",1390,"قم",0,0,0
"1589","16 ساله","دختر","غیرساکن",1390,"قم",0,0,0
"1590","17 ساله","دختر","غیرساکن",1390,"قم",0,0,0
"1591","18 ساله","دختر","غیرساکن",1390,"قم",0,0,0
"1592","19 ساله","دختر","غیرساکن",1390,"قم",0,0,0
"1593","6 ساله","دختر","غیرساکن",1390,"قم",0,0,0
"1594","7 ساله","دختر","غیرساکن",1390,"قم",0,0,0
"1595","8 ساله","دختر","غیرساکن",1390,"قم",0,0,0
"1596","9 ساله","دختر","غیرساکن",1390,"قم",0,0,0
"1597","10 ساله","پسر","روستا",1390,"كردستان",3879,130,3749
"1598","11 ساله","پسر","روستا",1390,"كردستان",3769,220,3549
"1599","12 ساله","پسر","روستا",1390,"كردستان",3898,302,3596
"1600","13 ساله","پسر","روستا",1390,"كردستان",4309,473,3836
"1601","14 ساله","پسر","روستا",1390,"كردستان",4367,852,3515
"1602","15 ساله","پسر","روستا",1390,"كردستان",4372,1427,2945
"1603","16 ساله","پسر","روستا",1390,"كردستان",5234,2207,3027
"1604","17 ساله","پسر","روستا",1390,"كردستان",5769,3560,2209
"1605","18 ساله","پسر","روستا",1390,"كردستان",5843,4579,1264
"1606","19 ساله","پسر","روستا",1390,"كردستان",5102,4363,739
"1607","6 ساله","پسر","روستا",1390,"كردستان",4036,781,3255
"1608","7 ساله","پسر","روستا",1390,"كردستان",4395,165,4230
"1609","8 ساله","پسر","روستا",1390,"كردستان",4121,119,4002
"1610","9 ساله","پسر","روستا",1390,"كردستان",3854,129,3725
"1611","10 ساله","دختر","روستا",1390,"كردستان",3769,191,3578
"1612","11 ساله","دختر","روستا",1390,"كردستان",3443,689,2754
"1613","12 ساله","دختر","روستا",1390,"كردستان",3813,1273,2540
"1614","13 ساله","دختر","روستا",1390,"كردستان",3880,1678,2202
"1615","14 ساله","دختر","روستا",1390,"كردستان",4182,2374,1808
"1616","15 ساله","دختر","روستا",1390,"كردستان",4306,2908,1398
"1617","16 ساله","دختر","روستا",1390,"كردستان",5096,3674,1422
"1618","17 ساله","دختر","روستا",1390,"كردستان",5608,4491,1117
"1619","18 ساله","دختر","روستا",1390,"كردستان",5818,5189,629
"1620","19 ساله","دختر","روستا",1390,"كردستان",6073,5576,497
"1621","6 ساله","دختر","روستا",1390,"كردستان",3988,776,3212
"1622","7 ساله","دختر","روستا",1390,"كردستان",4114,165,3949
"1623","8 ساله","دختر","روستا",1390,"كردستان",3710,131,3579
"1624","9 ساله","دختر","روستا",1390,"كردستان",3739,135,3604
"1625","10 ساله","پسر","شهر",1390,"كردستان",7023,232,6791
"1626","11 ساله","پسر","شهر",1390,"كردستان",7046,231,6815
"1627","12 ساله","پسر","شهر",1390,"كردستان",7263,290,6973
"1628","13 ساله","پسر","شهر",1390,"كردستان",7343,414,6929
"1629","14 ساله","پسر","شهر",1390,"كردستان",7884,633,7251
"1630","15 ساله","پسر","شهر",1390,"كردستان",8112,1179,6933
"1631","16 ساله","پسر","شهر",1390,"كردستان",9361,2000,7361
"1632","17 ساله","پسر","شهر",1390,"كردستان",9769,3344,6425
"1633","18 ساله","پسر","شهر",1390,"كردستان",9613,5100,4513
"1634","19 ساله","پسر","شهر",1390,"كردستان",10000,5788,4212
"1635","6 ساله","پسر","شهر",1390,"كردستان",7694,1566,6128
"1636","7 ساله","پسر","شهر",1390,"كردستان",7251,313,6938
"1637","8 ساله","پسر","شهر",1390,"كردستان",7008,273,6735
"1638","9 ساله","پسر","شهر",1390,"كردستان",6801,230,6571
"1639","10 ساله","دختر","شهر",1390,"كردستان",6825,242,6583
"1640","11 ساله","دختر","شهر",1390,"كردستان",6751,355,6396
"1641","12 ساله","دختر","شهر",1390,"كردستان",6961,433,6528
"1642","13 ساله","دختر","شهر",1390,"كردستان",7246,577,6669
"1643","14 ساله","دختر","شهر",1390,"كردستان",7632,944,6688
"1644","15 ساله","دختر","شهر",1390,"كردستان",8126,1617,6509
"1645","16 ساله","دختر","شهر",1390,"كردستان",8969,2408,6561
"1646","17 ساله","دختر","شهر",1390,"كردستان",9695,3849,5846
"1647","18 ساله","دختر","شهر",1390,"كردستان",10027,5984,4043
"1648","19 ساله","دختر","شهر",1390,"كردستان",10451,6405,4046
"1649","6 ساله","دختر","شهر",1390,"كردستان",7369,1468,5901
"1650","7 ساله","دختر","شهر",1390,"كردستان",7037,307,6730
"1651","8 ساله","دختر","شهر",1390,"كردستان",6752,278,6474
"1652","9 ساله","دختر","شهر",1390,"كردستان",6551,285,6266
"1653","10 ساله","پسر","غیرساکن",1390,"كردستان",0,0,0
"1654","11 ساله","پسر","غیرساکن",1390,"كردستان",0,0,0
"1655","12 ساله","پسر","غیرساکن",1390,"كردستان",0,0,0
"1656","13 ساله","پسر","غیرساکن",1390,"كردستان",0,0,0
"1657","14 ساله","پسر","غیرساکن",1390,"كردستان",0,0,0
"1658","15 ساله","پسر","غیرساکن",1390,"كردستان",0,0,0
"1659","16 ساله","پسر","غیرساکن",1390,"كردستان",0,0,0
"1660","17 ساله","پسر","غیرساکن",1390,"كردستان",0,0,0
"1661","18 ساله","پسر","غیرساکن",1390,"كردستان",0,0,0
"1662","19 ساله","پسر","غیرساکن",1390,"كردستان",0,0,0
"1663","6 ساله","پسر","غیرساکن",1390,"كردستان",0,0,0
"1664","7 ساله","پسر","غیرساکن",1390,"كردستان",0,0,0
"1665","8 ساله","پسر","غیرساکن",1390,"كردستان",0,0,0
"1666","9 ساله","پسر","غیرساکن",1390,"كردستان",0,0,0
"1667","10 ساله","دختر","غیرساکن",1390,"كردستان",0,0,0
"1668","11 ساله","دختر","غیرساکن",1390,"كردستان",0,0,0
"1669","12 ساله","دختر","غیرساکن",1390,"كردستان",0,0,0
"1670","13 ساله","دختر","غیرساکن",1390,"كردستان",0,0,0
"1671","14 ساله","دختر","غیرساکن",1390,"كردستان",0,0,0
"1672","15 ساله","دختر","غیرساکن",1390,"كردستان",0,0,0
"1673","16 ساله","دختر","غیرساکن",1390,"كردستان",0,0,0
"1674","17 ساله","دختر","غیرساکن",1390,"كردستان",0,0,0
"1675","18 ساله","دختر","غیرساکن",1390,"كردستان",0,0,0
"1676","19 ساله","دختر","غیرساکن",1390,"كردستان",0,0,0
"1677","6 ساله","دختر","غیرساکن",1390,"كردستان",0,0,0
"1678","7 ساله","دختر","غیرساکن",1390,"كردستان",0,0,0
"1679","8 ساله","دختر","غیرساکن",1390,"كردستان",0,0,0
"1680","9 ساله","دختر","غیرساکن",1390,"كردستان",0,0,0
"1681","10 ساله","پسر","روستا",1390,"كرمانشاه",4235,193,4042
"1682","11 ساله","پسر","روستا",1390,"كرمانشاه",4210,221,3989
"1683","12 ساله","پسر","روستا",1390,"كرمانشاه",4474,319,4155
"1684","13 ساله","پسر","روستا",1390,"كرمانشاه",4509,399,4110
"1685","14 ساله","پسر","روستا",1390,"كرمانشاه",4871,634,4237
"1686","15 ساله","پسر","روستا",1390,"كرمانشاه",5352,978,4374
"1687","16 ساله","پسر","روستا",1390,"كرمانشاه",6133,1587,4546
"1688","17 ساله","پسر","روستا",1390,"كرمانشاه",6515,2807,3708
"1689","18 ساله","پسر","روستا",1390,"كرمانشاه",7582,5061,2521
"1690","19 ساله","پسر","روستا",1390,"كرمانشاه",8697,6892,1805
"1691","6 ساله","پسر","روستا",1390,"كرمانشاه",4583,972,3611
"1692","7 ساله","پسر","روستا",1390,"كرمانشاه",4457,209,4248
"1693","8 ساله","پسر","روستا",1390,"كرمانشاه",4177,178,3999
"1694","9 ساله","پسر","روستا",1390,"كرمانشاه",4144,153,3991
"1695","10 ساله","دختر","روستا",1390,"كرمانشاه",4038,206,3832
"1696","11 ساله","دختر","روستا",1390,"كرمانشاه",3944,527,3417
"1697","12 ساله","دختر","روستا",1390,"كرمانشاه",4122,889,3233
"1698","13 ساله","دختر","روستا",1390,"كرمانشاه",4447,1223,3224
"1699","14 ساله","دختر","روستا",1390,"كرمانشاه",4670,1746,2924
"1700","15 ساله","دختر","روستا",1390,"كرمانشاه",4871,2295,2576
"1701","16 ساله","دختر","روستا",1390,"كرمانشاه",5564,2943,2621
"1702","17 ساله","دختر","روستا",1390,"كرمانشاه",5850,3752,2098
"1703","18 ساله","دختر","روستا",1390,"كرمانشاه",6021,4716,1305
"1704","19 ساله","دختر","روستا",1390,"كرمانشاه",5931,4939,992
"1705","6 ساله","دختر","روستا",1390,"كرمانشاه",4333,967,3366
"1706","7 ساله","دختر","روستا",1390,"كرمانشاه",4201,197,4004
"1707","8 ساله","دختر","روستا",1390,"كرمانشاه",4108,194,3914
"1708","9 ساله","دختر","روستا",1390,"كرمانشاه",3860,170,3690
"1709","10 ساله","پسر","شهر",1390,"كرمانشاه",9501,298,9203
"1710","11 ساله","پسر","شهر",1390,"كرمانشاه",9123,279,8844
"1711","12 ساله","پسر","شهر",1390,"كرمانشاه",9337,267,9070
"1712","13 ساله","پسر","شهر",1390,"كرمانشاه",9644,348,9296
"1713","14 ساله","پسر","شهر",1390,"كرمانشاه",10591,536,10055
"1714","15 ساله","پسر","شهر",1390,"كرمانشاه",10837,992,9845
"1715","16 ساله","پسر","شهر",1390,"كرمانشاه",12176,1669,10507
"1716","17 ساله","پسر","شهر",1390,"كرمانشاه",13137,3635,9502
"1717","18 ساله","پسر","شهر",1390,"كرمانشاه",13434,6240,7194
"1718","19 ساله","پسر","شهر",1390,"كرمانشاه",14382,7820,6562
"1719","6 ساله","پسر","شهر",1390,"كرمانشاه",9571,2016,7555
"1720","7 ساله","پسر","شهر",1390,"كرمانشاه",9054,300,8754
"1721","8 ساله","پسر","شهر",1390,"كرمانشاه",8919,280,8639
"1722","9 ساله","پسر","شهر",1390,"كرمانشاه",8645,252,8393
"1723","10 ساله","دختر","شهر",1390,"كرمانشاه",8746,280,8466
"1724","11 ساله","دختر","شهر",1390,"كرمانشاه",8524,308,8216
"1725","12 ساله","دختر","شهر",1390,"كرمانشاه",8989,341,8648
"1726","13 ساله","دختر","شهر",1390,"كرمانشاه",9530,503,9027
"1727","14 ساله","دختر","شهر",1390,"كرمانشاه",10139,836,9303
"1728","15 ساله","دختر","شهر",1390,"كرمانشاه",10346,1465,8881
"1729","16 ساله","دختر","شهر",1390,"كرمانشاه",11976,2433,9543
"1730","17 ساله","دختر","شهر",1390,"كرمانشاه",12944,4263,8681
"1731","18 ساله","دختر","شهر",1390,"كرمانشاه",13177,7600,5577
"1732","19 ساله","دختر","شهر",1390,"كرمانشاه",14261,8347,5914
"1733","6 ساله","دختر","شهر",1390,"كرمانشاه",8872,1844,7028
"1734","7 ساله","دختر","شهر",1390,"كرمانشاه",8828,328,8500
"1735","8 ساله","دختر","شهر",1390,"كرمانشاه",8391,249,8142
"1736","9 ساله","دختر","شهر",1390,"كرمانشاه",8141,239,7902
"1737","10 ساله","پسر","غیرساکن",1390,"كرمانشاه",25,4,21
"1738","11 ساله","پسر","غیرساکن",1390,"كرمانشاه",26,4,22
"1739","12 ساله","پسر","غیرساکن",1390,"كرمانشاه",35,14,21
"1740","13 ساله","پسر","غیرساکن",1390,"كرمانشاه",36,18,18
"1741","14 ساله","پسر","غیرساکن",1390,"كرمانشاه",38,17,21
"1742","15 ساله","پسر","غیرساکن",1390,"كرمانشاه",32,17,15
"1743","16 ساله","پسر","غیرساکن",1390,"كرمانشاه",44,31,13
"1744","17 ساله","پسر","غیرساکن",1390,"كرمانشاه",34,28,6
"1745","18 ساله","پسر","غیرساکن",1390,"كرمانشاه",46,39,7
"1746","19 ساله","پسر","غیرساکن",1390,"كرمانشاه",42,38,4
"1747","6 ساله","پسر","غیرساکن",1390,"كرمانشاه",34,21,13
"1748","7 ساله","پسر","غیرساکن",1390,"كرمانشاه",16,2,14
"1749","8 ساله","پسر","غیرساکن",1390,"كرمانشاه",34,3,31
"1750","9 ساله","پسر","غیرساکن",1390,"كرمانشاه",24,7,17
"1751","10 ساله","دختر","غیرساکن",1390,"كرمانشاه",24,10,14
"1752","11 ساله","دختر","غیرساکن",1390,"كرمانشاه",19,13,6
"1753","12 ساله","دختر","غیرساکن",1390,"كرمانشاه",23,19,4
"1754","13 ساله","دختر","غیرساکن",1390,"كرمانشاه",33,22,11
"1755","14 ساله","دختر","غیرساکن",1390,"كرمانشاه",29,26,3
"1756","15 ساله","دختر","غیرساکن",1390,"كرمانشاه",36,36,0
"1757","16 ساله","دختر","غیرساکن",1390,"كرمانشاه",43,40,3
"1758","17 ساله","دختر","غیرساکن",1390,"كرمانشاه",34,32,2
"1759","18 ساله","دختر","غیرساکن",1390,"كرمانشاه",40,40,0
"1760","19 ساله","دختر","غیرساکن",1390,"كرمانشاه",29,29,0
"1761","6 ساله","دختر","غیرساکن",1390,"كرمانشاه",31,23,8
"1762","7 ساله","دختر","غیرساکن",1390,"كرمانشاه",27,13,14
"1763","8 ساله","دختر","غیرساکن",1390,"كرمانشاه",20,6,14
"1764","9 ساله","دختر","غیرساکن",1390,"كرمانشاه",18,10,8
"1765","10 ساله","پسر","روستا",1390,"كهگيلويه وبويراحمد",2485,95,2390
"1766","11 ساله","پسر","روستا",1390,"كهگيلويه وبويراحمد",2289,99,2190
"1767","12 ساله","پسر","روستا",1390,"كهگيلويه وبويراحمد",2567,123,2444
"1768","13 ساله","پسر","روستا",1390,"كهگيلويه وبويراحمد",2686,162,2524
"1769","14 ساله","پسر","روستا",1390,"كهگيلويه وبويراحمد",2697,221,2476
"1770","15 ساله","پسر","روستا",1390,"كهگيلويه وبويراحمد",2546,337,2209
"1771","16 ساله","پسر","روستا",1390,"كهگيلويه وبويراحمد",2845,481,2364
"1772","17 ساله","پسر","روستا",1390,"كهگيلويه وبويراحمد",3198,1122,2076
"1773","18 ساله","پسر","روستا",1390,"كهگيلويه وبويراحمد",3587,1886,1701
"1774","19 ساله","پسر","روستا",1390,"كهگيلويه وبويراحمد",3329,1978,1351
"1775","6 ساله","پسر","روستا",1390,"كهگيلويه وبويراحمد",2916,583,2333
"1776","7 ساله","پسر","روستا",1390,"كهگيلويه وبويراحمد",2742,104,2638
"1777","8 ساله","پسر","روستا",1390,"كهگيلويه وبويراحمد",2658,98,2560
"1778","9 ساله","پسر","روستا",1390,"كهگيلويه وبويراحمد",2653,90,2563
"1779","10 ساله","دختر","روستا",1390,"كهگيلويه وبويراحمد",2432,117,2315
"1780","11 ساله","دختر","روستا",1390,"كهگيلويه وبويراحمد",2302,161,2141
"1781","12 ساله","دختر","روستا",1390,"كهگيلويه وبويراحمد",2458,277,2181
"1782","13 ساله","دختر","روستا",1390,"كهگيلويه وبويراحمد",2460,389,2071
"1783","14 ساله","دختر","روستا",1390,"كهگيلويه وبويراحمد",2525,580,1945
"1784","15 ساله","دختر","روستا",1390,"كهگيلويه وبويراحمد",2636,757,1879
"1785","16 ساله","دختر","روستا",1390,"كهگيلويه وبويراحمد",3069,1150,1919
"1786","17 ساله","دختر","روستا",1390,"كهگيلويه وبويراحمد",3428,1640,1788
"1787","18 ساله","دختر","روستا",1390,"كهگيلويه وبويراحمد",3639,2369,1270
"1788","19 ساله","دختر","روستا",1390,"كهگيلويه وبويراحمد",3668,2729,939
"1789","6 ساله","دختر","روستا",1390,"كهگيلويه وبويراحمد",2800,535,2265
"1790","7 ساله","دختر","روستا",1390,"كهگيلويه وبويراحمد",2533,100,2433
"1791","8 ساله","دختر","روستا",1390,"كهگيلويه وبويراحمد",2537,105,2432
"1792","9 ساله","دختر","روستا",1390,"كهگيلويه وبويراحمد",2531,113,2418
"1793","10 ساله","پسر","شهر",1390,"كهگيلويه وبويراحمد",2745,69,2676
"1794","11 ساله","پسر","شهر",1390,"كهگيلويه وبويراحمد",2704,60,2644
"1795","12 ساله","پسر","شهر",1390,"كهگيلويه وبويراحمد",2917,66,2851
"1796","13 ساله","پسر","شهر",1390,"كهگيلويه وبويراحمد",2811,62,2749
"1797","14 ساله","پسر","شهر",1390,"كهگيلويه وبويراحمد",3112,93,3019
"1798","15 ساله","پسر","شهر",1390,"كهگيلويه وبويراحمد",3288,155,3133
"1799","16 ساله","پسر","شهر",1390,"كهگيلويه وبويراحمد",3678,218,3460
"1800","17 ساله","پسر","شهر",1390,"كهگيلويه وبويراحمد",3762,755,3007
"1801","18 ساله","پسر","شهر",1390,"كهگيلويه وبويراحمد",3904,1538,2366
"1802","19 ساله","پسر","شهر",1390,"كهگيلويه وبويراحمد",3754,1431,2323
"1803","6 ساله","پسر","شهر",1390,"كهگيلويه وبويراحمد",2952,592,2360
"1804","7 ساله","پسر","شهر",1390,"كهگيلويه وبويراحمد",2846,81,2765
"1805","8 ساله","پسر","شهر",1390,"كهگيلويه وبويراحمد",2837,85,2752
"1806","9 ساله","پسر","شهر",1390,"كهگيلويه وبويراحمد",2764,83,2681
"1807","10 ساله","دختر","شهر",1390,"كهگيلويه وبويراحمد",2670,72,2598
"1808","11 ساله","دختر","شهر",1390,"كهگيلويه وبويراحمد",2524,60,2464
"1809","12 ساله","دختر","شهر",1390,"كهگيلويه وبويراحمد",2731,67,2664
"1810","13 ساله","دختر","شهر",1390,"كهگيلويه وبويراحمد",2738,85,2653
"1811","14 ساله","دختر","شهر",1390,"كهگيلويه وبويراحمد",2952,131,2821
"1812","15 ساله","دختر","شهر",1390,"كهگيلويه وبويراحمد",3172,238,2934
"1813","16 ساله","دختر","شهر",1390,"كهگيلويه وبويراحمد",3425,371,3054
"1814","17 ساله","دختر","شهر",1390,"كهگيلويه وبويراحمد",3934,846,3088
"1815","18 ساله","دختر","شهر",1390,"كهگيلويه وبويراحمد",3876,1804,2072
"1816","19 ساله","دختر","شهر",1390,"كهگيلويه وبويراحمد",4090,1941,2149
"1817","6 ساله","دختر","شهر",1390,"كهگيلويه وبويراحمد",2785,559,2226
"1818","7 ساله","دختر","شهر",1390,"كهگيلويه وبويراحمد",2772,99,2673
"1819","8 ساله","دختر","شهر",1390,"كهگيلويه وبويراحمد",2698,62,2636
"1820","9 ساله","دختر","شهر",1390,"كهگيلويه وبويراحمد",2642,90,2552
"1821","10 ساله","پسر","غیرساکن",1390,"كهگيلويه وبويراحمد",9,0,9
"1822","11 ساله","پسر","غیرساکن",1390,"كهگيلويه وبويراحمد",5,0,5
"1823","12 ساله","پسر","غیرساکن",1390,"كهگيلويه وبويراحمد",8,1,7
"1824","13 ساله","پسر","غیرساکن",1390,"كهگيلويه وبويراحمد",8,2,6
"1825","14 ساله","پسر","غیرساکن",1390,"كهگيلويه وبويراحمد",12,1,11
"1826","15 ساله","پسر","غیرساکن",1390,"كهگيلويه وبويراحمد",17,4,13
"1827","16 ساله","پسر","غیرساکن",1390,"كهگيلويه وبويراحمد",12,4,8
"1828","17 ساله","پسر","غیرساکن",1390,"كهگيلويه وبويراحمد",18,8,10
"1829","18 ساله","پسر","غیرساکن",1390,"كهگيلويه وبويراحمد",29,13,16
"1830","19 ساله","پسر","غیرساکن",1390,"كهگيلويه وبويراحمد",15,10,5
"1831","6 ساله","پسر","غیرساکن",1390,"كهگيلويه وبويراحمد",10,5,5
"1832","7 ساله","پسر","غیرساکن",1390,"كهگيلويه وبويراحمد",16,2,14
"1833","8 ساله","پسر","غیرساکن",1390,"كهگيلويه وبويراحمد",16,1,15
"1834","9 ساله","پسر","غیرساکن",1390,"كهگيلويه وبويراحمد",4,0,4
"1835","10 ساله","دختر","غیرساکن",1390,"كهگيلويه وبويراحمد",16,1,15
"1836","11 ساله","دختر","غیرساکن",1390,"كهگيلويه وبويراحمد",6,1,5
"1837","12 ساله","دختر","غیرساکن",1390,"كهگيلويه وبويراحمد",4,0,4
"1838","13 ساله","دختر","غیرساکن",1390,"كهگيلويه وبويراحمد",8,2,6
"1839","14 ساله","دختر","غیرساکن",1390,"كهگيلويه وبويراحمد",17,9,8
"1840","15 ساله","دختر","غیرساکن",1390,"كهگيلويه وبويراحمد",13,7,6
"1841","16 ساله","دختر","غیرساکن",1390,"كهگيلويه وبويراحمد",14,7,7
"1842","17 ساله","دختر","غیرساکن",1390,"كهگيلويه وبويراحمد",17,12,5
"1843","18 ساله","دختر","غیرساکن",1390,"كهگيلويه وبويراحمد",16,11,5
"1844","19 ساله","دختر","غیرساکن",1390,"كهگيلويه وبويراحمد",18,14,4
"1845","6 ساله","دختر","غیرساکن",1390,"كهگيلويه وبويراحمد",5,3,2
"1846","7 ساله","دختر","غیرساکن",1390,"كهگيلويه وبويراحمد",11,4,7
"1847","8 ساله","دختر","غیرساکن",1390,"كهگيلويه وبويراحمد",9,1,8
"1848","9 ساله","دختر","غیرساکن",1390,"كهگيلويه وبويراحمد",7,3,4
"1849","10 ساله","پسر","روستا",1390,"گلستان",6587,289,6298
"1850","11 ساله","پسر","روستا",1390,"گلستان",7042,369,6673
"1851","12 ساله","پسر","روستا",1390,"گلستان",7119,566,6553
"1852","13 ساله","پسر","روستا",1390,"گلستان",7056,899,6157
"1853","14 ساله","پسر","روستا",1390,"گلستان",7597,1601,5996
"1854","15 ساله","پسر","روستا",1390,"گلستان",8077,2643,5434
"1855","16 ساله","پسر","روستا",1390,"گلستان",8868,3617,5251
"1856","17 ساله","پسر","روستا",1390,"گلستان",8979,5120,3859
"1857","18 ساله","پسر","روستا",1390,"گلستان",9151,6527,2624
"1858","19 ساله","پسر","روستا",1390,"گلستان",8144,6087,2057
"1859","6 ساله","پسر","روستا",1390,"گلستان",8450,2124,6326
"1860","7 ساله","پسر","روستا",1390,"گلستان",7566,361,7205
"1861","8 ساله","پسر","روستا",1390,"گلستان",6901,279,6622
"1862","9 ساله","پسر","روستا",1390,"گلستان",6863,273,6590
"1863","10 ساله","دختر","روستا",1390,"گلستان",6260,327,5933
"1864","11 ساله","دختر","روستا",1390,"گلستان",6748,805,5943
"1865","12 ساله","دختر","روستا",1390,"گلستان",6728,1238,5490
"1866","13 ساله","دختر","روستا",1390,"گلستان",6688,1747,4941
"1867","14 ساله","دختر","روستا",1390,"گلستان",7320,2771,4549
"1868","15 ساله","دختر","روستا",1390,"گلستان",7897,3861,4036
"1869","16 ساله","دختر","روستا",1390,"گلستان",8601,4816,3785
"1870","17 ساله","دختر","روستا",1390,"گلستان",8560,5817,2743
"1871","18 ساله","دختر","روستا",1390,"گلستان",8978,7208,1770
"1872","19 ساله","دختر","روستا",1390,"گلستان",9305,7693,1612
"1873","6 ساله","دختر","روستا",1390,"گلستان",8097,2074,6023
"1874","7 ساله","دختر","روستا",1390,"گلستان",7405,364,7041
"1875","8 ساله","دختر","روستا",1390,"گلستان",6570,301,6269
"1876","9 ساله","دختر","روستا",1390,"گلستان",6431,282,6149
"1877","10 ساله","پسر","شهر",1390,"گلستان",6690,200,6490
"1878","11 ساله","پسر","شهر",1390,"گلستان",6898,234,6664
"1879","12 ساله","پسر","شهر",1390,"گلستان",6865,301,6564
"1880","13 ساله","پسر","شهر",1390,"گلستان",6790,372,6418
"1881","14 ساله","پسر","شهر",1390,"گلستان",7085,584,6501
"1882","15 ساله","پسر","شهر",1390,"گلستان",7341,975,6366
"1883","16 ساله","پسر","شهر",1390,"گلستان",7782,1392,6390
"1884","17 ساله","پسر","شهر",1390,"گلستان",7961,2505,5456
"1885","18 ساله","پسر","شهر",1390,"گلستان",8415,3918,4497
"1886","19 ساله","پسر","شهر",1390,"گلستان",8821,4476,4345
"1887","6 ساله","پسر","شهر",1390,"گلستان",7226,1578,5648
"1888","7 ساله","پسر","شهر",1390,"گلستان",6771,289,6482
"1889","8 ساله","پسر","شهر",1390,"گلستان",6520,237,6283
"1890","9 ساله","پسر","شهر",1390,"گلستان",6501,200,6301
"1891","10 ساله","دختر","شهر",1390,"گلستان",6531,207,6324
"1892","11 ساله","دختر","شهر",1390,"گلستان",6721,240,6481
"1893","12 ساله","دختر","شهر",1390,"گلستان",6953,330,6623
"1894","13 ساله","دختر","شهر",1390,"گلستان",6956,445,6511
"1895","14 ساله","دختر","شهر",1390,"گلستان",6878,713,6165
"1896","15 ساله","دختر","شهر",1390,"گلستان",7154,1129,6025
"1897","16 ساله","دختر","شهر",1390,"گلستان",7784,1530,6254
"1898","17 ساله","دختر","شهر",1390,"گلستان",7981,2403,5578
"1899","18 ساله","دختر","شهر",1390,"گلستان",8245,4192,4053
"1900","19 ساله","دختر","شهر",1390,"گلستان",8851,4293,4558
"1901","6 ساله","دختر","شهر",1390,"گلستان",6876,1566,5310
"1902","7 ساله","دختر","شهر",1390,"گلستان",6339,283,6056
"1903","8 ساله","دختر","شهر",1390,"گلستان",6310,249,6061
"1904","9 ساله","دختر","شهر",1390,"گلستان",6374,217,6157
"1905","10 ساله","پسر","غیرساکن",1390,"گلستان",9,0,9
"1906","11 ساله","پسر","غیرساکن",1390,"گلستان",7,2,5
"1907","12 ساله","پسر","غیرساکن",1390,"گلستان",7,3,4
"1908","13 ساله","پسر","غیرساکن",1390,"گلستان",9,4,5
"1909","14 ساله","پسر","غیرساکن",1390,"گلستان",6,2,4
"1910","15 ساله","پسر","غیرساکن",1390,"گلستان",8,5,3
"1911","16 ساله","پسر","غیرساکن",1390,"گلستان",5,5,0
"1912","17 ساله","پسر","غیرساکن",1390,"گلستان",9,9,0
"1913","18 ساله","پسر","غیرساکن",1390,"گلستان",8,7,1
"1914","19 ساله","پسر","غیرساکن",1390,"گلستان",6,6,0
"1915","6 ساله","پسر","غیرساکن",1390,"گلستان",17,5,12
"1916","7 ساله","پسر","غیرساکن",1390,"گلستان",5,0,5
"1917","8 ساله","پسر","غیرساکن",1390,"گلستان",8,1,7
"1918","9 ساله","پسر","غیرساکن",1390,"گلستان",8,0,8
"1919","10 ساله","دختر","غیرساکن",1390,"گلستان",8,2,6
"1920","11 ساله","دختر","غیرساکن",1390,"گلستان",8,1,7
"1921","12 ساله","دختر","غیرساکن",1390,"گلستان",9,7,2
"1922","13 ساله","دختر","غیرساکن",1390,"گلستان",5,5,0
"1923","14 ساله","دختر","غیرساکن",1390,"گلستان",8,7,1
"1924","15 ساله","دختر","غیرساکن",1390,"گلستان",10,9,1
"1925","16 ساله","دختر","غیرساکن",1390,"گلستان",8,8,0
"1926","17 ساله","دختر","غیرساکن",1390,"گلستان",3,3,0
"1927","18 ساله","دختر","غیرساکن",1390,"گلستان",9,9,0
"1928","19 ساله","دختر","غیرساکن",1390,"گلستان",6,6,0
"1929","6 ساله","دختر","غیرساکن",1390,"گلستان",5,2,3
"1930","7 ساله","دختر","غیرساکن",1390,"گلستان",6,1,5
"1931","8 ساله","دختر","غیرساکن",1390,"گلستان",5,0,5
"1932","9 ساله","دختر","غیرساکن",1390,"گلستان",5,0,5
"1933","10 ساله","پسر","روستا",1390,"گيلان",6792,267,6525
"1934","11 ساله","پسر","روستا",1390,"گيلان",7036,330,6706
"1935","12 ساله","پسر","روستا",1390,"گيلان",6919,380,6539
"1936","13 ساله","پسر","روستا",1390,"گيلان",7270,561,6709
"1937","14 ساله","پسر","روستا",1390,"گيلان",7699,879,6820
"1938","15 ساله","پسر","روستا",1390,"گيلان",7817,1491,6326
"1939","16 ساله","پسر","روستا",1390,"گيلان",8084,2156,5928
"1940","17 ساله","پسر","روستا",1390,"گيلان",8844,4243,4601
"1941","18 ساله","پسر","روستا",1390,"گيلان",9308,6017,3291
"1942","19 ساله","پسر","روستا",1390,"گيلان",8268,5660,2608
"1943","6 ساله","پسر","روستا",1390,"گيلان",6115,1340,4775
"1944","7 ساله","پسر","روستا",1390,"گيلان",5748,261,5487
"1945","8 ساله","پسر","روستا",1390,"گيلان",5970,240,5730
"1946","9 ساله","پسر","روستا",1390,"گيلان",5972,220,5752
"1947","10 ساله","دختر","روستا",1390,"گيلان",6676,276,6400
"1948","11 ساله","دختر","روستا",1390,"گيلان",6459,334,6125
"1949","12 ساله","دختر","روستا",1390,"گيلان",6689,492,6197
"1950","13 ساله","دختر","روستا",1390,"گيلان",6710,670,6040
"1951","14 ساله","دختر","روستا",1390,"گيلان",7283,1096,6187
"1952","15 ساله","دختر","روستا",1390,"گيلان",7492,1826,5666
"1953","16 ساله","دختر","روستا",1390,"گيلان",7659,2404,5255
"1954","17 ساله","دختر","روستا",1390,"گيلان",8170,3944,4226
"1955","18 ساله","دختر","روستا",1390,"گيلان",8915,5939,2976
"1956","19 ساله","دختر","روستا",1390,"گيلان",9044,6445,2599
"1957","6 ساله","دختر","روستا",1390,"گيلان",5859,1289,4570
"1958","7 ساله","دختر","روستا",1390,"گيلان",5477,225,5252
"1959","8 ساله","دختر","روستا",1390,"گيلان",5702,217,5485
"1960","9 ساله","دختر","روستا",1390,"گيلان",5932,215,5717
"1961","10 ساله","پسر","شهر",1390,"گيلان",10394,315,10079
"1962","11 ساله","پسر","شهر",1390,"گيلان",10262,293,9969
"1963","12 ساله","پسر","شهر",1390,"گيلان",9953,297,9656
"1964","13 ساله","پسر","شهر",1390,"گيلان",10113,318,9795
"1965","14 ساله","پسر","شهر",1390,"گيلان",10571,494,10077
"1966","15 ساله","پسر","شهر",1390,"گيلان",10298,939,9359
"1967","16 ساله","پسر","شهر",1390,"گيلان",10878,1353,9525
"1968","17 ساله","پسر","شهر",1390,"گيلان",11821,3254,8567
"1969","18 ساله","پسر","شهر",1390,"گيلان",13019,5442,7577
"1970","19 ساله","پسر","شهر",1390,"گيلان",13576,5975,7601
"1971","6 ساله","پسر","شهر",1390,"گيلان",9308,1850,7458
"1972","7 ساله","پسر","شهر",1390,"گيلان",8723,328,8395
"1973","8 ساله","پسر","شهر",1390,"گيلان",9270,275,8995
"1974","9 ساله","پسر","شهر",1390,"گيلان",9203,272,8931
"1975","10 ساله","دختر","شهر",1390,"گيلان",10174,290,9884
"1976","11 ساله","دختر","شهر",1390,"گيلان",9996,250,9746
"1977","12 ساله","دختر","شهر",1390,"گيلان",9968,261,9707
"1978","13 ساله","دختر","شهر",1390,"گيلان",9946,302,9644
"1979","14 ساله","دختر","شهر",1390,"گيلان",10431,533,9898
"1980","15 ساله","دختر","شهر",1390,"گيلان",10536,805,9731
"1981","16 ساله","دختر","شهر",1390,"گيلان",10986,1293,9693
"1982","17 ساله","دختر","شهر",1390,"گيلان",11627,2825,8802
"1983","18 ساله","دختر","شهر",1390,"گيلان",12621,5831,6790
"1984","19 ساله","دختر","شهر",1390,"گيلان",13866,6135,7731
"1985","6 ساله","دختر","شهر",1390,"گيلان",8988,1823,7165
"1986","7 ساله","دختر","شهر",1390,"گيلان",8500,255,8245
"1987","8 ساله","دختر","شهر",1390,"گيلان",8875,230,8645
"1988","9 ساله","دختر","شهر",1390,"گيلان",8435,233,8202
"1989","10 ساله","پسر","غیرساکن",1390,"گيلان",0,0,0
"1990","11 ساله","پسر","غیرساکن",1390,"گيلان",0,0,0
"1991","12 ساله","پسر","غیرساکن",1390,"گيلان",0,0,0
"1992","13 ساله","پسر","غیرساکن",1390,"گيلان",0,0,0
"1993","14 ساله","پسر","غیرساکن",1390,"گيلان",0,0,0
"1994","15 ساله","پسر","غیرساکن",1390,"گيلان",0,0,0
"1995","16 ساله","پسر","غیرساکن",1390,"گيلان",0,0,0
"1996","17 ساله","پسر","غیرساکن",1390,"گيلان",0,0,0
"1997","18 ساله","پسر","غیرساکن",1390,"گيلان",0,0,0
"1998","19 ساله","پسر","غیرساکن",1390,"گيلان",0,0,0
"1999","6 ساله","پسر","غیرساکن",1390,"گيلان",0,0,0
"2000","7 ساله","پسر","غیرساکن",1390,"گيلان",0,0,0
"2001","8 ساله","پسر","غیرساکن",1390,"گيلان",0,0,0
"2002","9 ساله","پسر","غیرساکن",1390,"گيلان",0,0,0
"2003","10 ساله","دختر","غیرساکن",1390,"گيلان",0,0,0
"2004","11 ساله","دختر","غیرساکن",1390,"گيلان",0,0,0
"2005","12 ساله","دختر","غیرساکن",1390,"گيلان",0,0,0
"2006","13 ساله","دختر","غیرساکن",1390,"گيلان",0,0,0
"2007","14 ساله","دختر","غیرساکن",1390,"گيلان",0,0,0
"2008","15 ساله","دختر","غیرساکن",1390,"گيلان",0,0,0
"2009","16 ساله","دختر","غیرساکن",1390,"گيلان",0,0,0
"2010","17 ساله","دختر","غیرساکن",1390,"گيلان",0,0,0
"2011","18 ساله","دختر","غیرساکن",1390,"گيلان",0,0,0
"2012","19 ساله","دختر","غیرساکن",1390,"گيلان",0,0,0
"2013","6 ساله","دختر","غیرساکن",1390,"گيلان",0,0,0
"2014","7 ساله","دختر","غیرساکن",1390,"گيلان",0,0,0
"2015","8 ساله","دختر","غیرساکن",1390,"گيلان",0,0,0
"2016","9 ساله","دختر","غیرساکن",1390,"گيلان",0,0,0
"2017","10 ساله","پسر","روستا",1390,"لرستان",5311,286,5025
"2018","11 ساله","پسر","روستا",1390,"لرستان",5267,359,4908
"2019","12 ساله","پسر","روستا",1390,"لرستان",5626,552,5074
"2020","13 ساله","پسر","روستا",1390,"لرستان",5556,679,4877
"2021","14 ساله","پسر","روستا",1390,"لرستان",6401,1020,5381
"2022","15 ساله","پسر","روستا",1390,"لرستان",6914,1558,5356
"2023","16 ساله","پسر","روستا",1390,"لرستان",7593,2169,5424
"2024","17 ساله","پسر","روستا",1390,"لرستان",8314,3717,4597
"2025","18 ساله","پسر","روستا",1390,"لرستان",8287,5083,3204
"2026","19 ساله","پسر","روستا",1390,"لرستان",8647,6086,2561
"2027","6 ساله","پسر","روستا",1390,"لرستان",5609,1215,4394
"2028","7 ساله","پسر","روستا",1390,"لرستان",5798,363,5435
"2029","8 ساله","پسر","روستا",1390,"لرستان",5625,288,5337
"2030","9 ساله","پسر","روستا",1390,"لرستان",5273,314,4959
"2031","10 ساله","دختر","روستا",1390,"لرستان",5187,379,4808
"2032","11 ساله","دختر","روستا",1390,"لرستان",4964,591,4373
"2033","12 ساله","دختر","روستا",1390,"لرستان",5334,934,4400
"2034","13 ساله","دختر","روستا",1390,"لرستان",5257,1181,4076
"2035","14 ساله","دختر","روستا",1390,"لرستان",6123,2006,4117
"2036","15 ساله","دختر","روستا",1390,"لرستان",6340,2538,3802
"2037","16 ساله","دختر","روستا",1390,"لرستان",6857,3165,3692
"2038","17 ساله","دختر","روستا",1390,"لرستان",7308,4248,3060
"2039","18 ساله","دختر","روستا",1390,"لرستان",7505,5568,1937
"2040","19 ساله","دختر","روستا",1390,"لرستان",7977,6178,1799
"2041","6 ساله","دختر","روستا",1390,"لرستان",5424,1263,4161
"2042","7 ساله","دختر","روستا",1390,"لرستان",5382,348,5034
"2043","8 ساله","دختر","روستا",1390,"لرستان",5337,306,5031
"2044","9 ساله","دختر","روستا",1390,"لرستان",4991,321,4670
"2045","10 ساله","پسر","شهر",1390,"لرستان",8009,325,7684
"2046","11 ساله","پسر","شهر",1390,"لرستان",7754,249,7505
"2047","12 ساله","پسر","شهر",1390,"لرستان",8182,312,7870
"2048","13 ساله","پسر","شهر",1390,"لرستان",8113,362,7751
"2049","14 ساله","پسر","شهر",1390,"لرستان",8643,500,8143
"2050","15 ساله","پسر","شهر",1390,"لرستان",8920,804,8116
"2051","16 ساله","پسر","شهر",1390,"لرستان",9985,1342,8643
"2052","17 ساله","پسر","شهر",1390,"لرستان",10502,3025,7477
"2053","18 ساله","پسر","شهر",1390,"لرستان",11110,5209,5901
"2054","19 ساله","پسر","شهر",1390,"لرستان",11374,5792,5582
"2055","6 ساله","پسر","شهر",1390,"لرستان",8066,1671,6395
"2056","7 ساله","پسر","شهر",1390,"لرستان",7503,339,7164
"2057","8 ساله","پسر","شهر",1390,"لرستان",7601,292,7309
"2058","9 ساله","پسر","شهر",1390,"لرستان",7377,273,7104
"2059","10 ساله","دختر","شهر",1390,"لرستان",7590,275,7315
"2060","11 ساله","دختر","شهر",1390,"لرستان",7321,260,7061
"2061","12 ساله","دختر","شهر",1390,"لرستان",7782,279,7503
"2062","13 ساله","دختر","شهر",1390,"لرستان",7825,375,7450
"2063","14 ساله","دختر","شهر",1390,"لرستان",8267,565,7702
"2064","15 ساله","دختر","شهر",1390,"لرستان",8831,1091,7740
"2065","16 ساله","دختر","شهر",1390,"لرستان",9707,1648,8059
"2066","17 ساله","دختر","شهر",1390,"لرستان",10447,3227,7220
"2067","18 ساله","دختر","شهر",1390,"لرستان",11008,6134,4874
"2068","19 ساله","دختر","شهر",1390,"لرستان",12032,6692,5340
"2069","6 ساله","دختر","شهر",1390,"لرستان",7553,1600,5953
"2070","7 ساله","دختر","شهر",1390,"لرستان",7126,335,6791
"2071","8 ساله","دختر","شهر",1390,"لرستان",6924,258,6666
"2072","9 ساله","دختر","شهر",1390,"لرستان",7246,286,6960
"2073","10 ساله","پسر","غیرساکن",1390,"لرستان",11,6,5
"2074","11 ساله","پسر","غیرساکن",1390,"لرستان",5,1,4
"2075","12 ساله","پسر","غیرساکن",1390,"لرستان",9,3,6
"2076","13 ساله","پسر","غیرساکن",1390,"لرستان",15,10,5
"2077","14 ساله","پسر","غیرساکن",1390,"لرستان",11,7,4
"2078","15 ساله","پسر","غیرساکن",1390,"لرستان",12,8,4
"2079","16 ساله","پسر","غیرساکن",1390,"لرستان",8,7,1
"2080","17 ساله","پسر","غیرساکن",1390,"لرستان",11,10,1
"2081","18 ساله","پسر","غیرساکن",1390,"لرستان",17,16,1
"2082","19 ساله","پسر","غیرساکن",1390,"لرستان",15,14,1
"2083","6 ساله","پسر","غیرساکن",1390,"لرستان",6,3,3
"2084","7 ساله","پسر","غیرساکن",1390,"لرستان",13,4,9
"2085","8 ساله","پسر","غیرساکن",1390,"لرستان",3,0,3
"2086","9 ساله","پسر","غیرساکن",1390,"لرستان",5,0,5
"2087","10 ساله","دختر","غیرساکن",1390,"لرستان",5,1,4
"2088","11 ساله","دختر","غیرساکن",1390,"لرستان",7,2,5
"2089","12 ساله","دختر","غیرساکن",1390,"لرستان",8,8,0
"2090","13 ساله","دختر","غیرساکن",1390,"لرستان",9,5,4
"2091","14 ساله","دختر","غیرساکن",1390,"لرستان",8,7,1
"2092","15 ساله","دختر","غیرساکن",1390,"لرستان",14,13,1
"2093","16 ساله","دختر","غیرساکن",1390,"لرستان",9,5,4
"2094","17 ساله","دختر","غیرساکن",1390,"لرستان",8,7,1
"2095","18 ساله","دختر","غیرساکن",1390,"لرستان",13,13,0
"2096","19 ساله","دختر","غیرساکن",1390,"لرستان",12,10,2
"2097","6 ساله","دختر","غیرساکن",1390,"لرستان",14,4,10
"2098","7 ساله","دختر","غیرساکن",1390,"لرستان",13,4,9
"2099","8 ساله","دختر","غیرساکن",1390,"لرستان",7,1,6
"2100","9 ساله","دختر","غیرساکن",1390,"لرستان",5,1,4
"2101","10 ساله","پسر","روستا",1390,"مازندران",9507,335,9172
"2102","11 ساله","پسر","روستا",1390,"مازندران",9673,326,9347
"2103","12 ساله","پسر","روستا",1390,"مازندران",9515,381,9134
"2104","13 ساله","پسر","روستا",1390,"مازندران",9241,488,8753
"2105","14 ساله","پسر","روستا",1390,"مازندران",9370,851,8519
"2106","15 ساله","پسر","روستا",1390,"مازندران",9531,1434,8097
"2107","16 ساله","پسر","روستا",1390,"مازندران",10201,2170,8031
"2108","17 ساله","پسر","روستا",1390,"مازندران",10712,4135,6577
"2109","18 ساله","پسر","روستا",1390,"مازندران",12218,6668,5550
"2110","19 ساله","پسر","روستا",1390,"مازندران",12511,7185,5326
"2111","6 ساله","پسر","روستا",1390,"مازندران",9613,2183,7430
"2112","7 ساله","پسر","روستا",1390,"مازندران",8941,368,8573
"2113","8 ساله","پسر","روستا",1390,"مازندران",9156,389,8767
"2114","9 ساله","پسر","روستا",1390,"مازندران",9149,334,8815
"2115","10 ساله","دختر","روستا",1390,"مازندران",9074,321,8753
"2116","11 ساله","دختر","روستا",1390,"مازندران",9293,332,8961
"2117","12 ساله","دختر","روستا",1390,"مازندران",9038,382,8656
"2118","13 ساله","دختر","روستا",1390,"مازندران",8961,529,8432
"2119","14 ساله","دختر","روستا",1390,"مازندران",9245,895,8350
"2120","15 ساله","دختر","روستا",1390,"مازندران",9595,1605,7990
"2121","16 ساله","دختر","روستا",1390,"مازندران",9763,2300,7463
"2122","17 ساله","دختر","روستا",1390,"مازندران",10323,3980,6343
"2123","18 ساله","دختر","روستا",1390,"مازندران",11440,6427,5013
"2124","19 ساله","دختر","روستا",1390,"مازندران",12202,7265,4937
"2125","6 ساله","دختر","روستا",1390,"مازندران",9355,2168,7187
"2126","7 ساله","دختر","روستا",1390,"مازندران",8366,378,7988
"2127","8 ساله","دختر","روستا",1390,"مازندران",8757,329,8428
"2128","9 ساله","دختر","روستا",1390,"مازندران",8665,309,8356
"2129","10 ساله","پسر","شهر",1390,"مازندران",12082,420,11662
"2130","11 ساله","پسر","شهر",1390,"مازندران",11854,333,11521
"2131","12 ساله","پسر","شهر",1390,"مازندران",11646,367,11279
"2132","13 ساله","پسر","شهر",1390,"مازندران",11661,397,11264
"2133","14 ساله","پسر","شهر",1390,"مازندران",11109,527,10582
"2134","15 ساله","پسر","شهر",1390,"مازندران",11372,992,10380
"2135","16 ساله","پسر","شهر",1390,"مازندران",11865,1447,10418
"2136","17 ساله","پسر","شهر",1390,"مازندران",12830,3131,9699
"2137","18 ساله","پسر","شهر",1390,"مازندران",14136,4939,9197
"2138","19 ساله","پسر","شهر",1390,"مازندران",15300,5431,9869
"2139","6 ساله","پسر","شهر",1390,"مازندران",11059,2466,8593
"2140","7 ساله","پسر","شهر",1390,"مازندران",10383,434,9949
"2141","8 ساله","پسر","شهر",1390,"مازندران",10592,329,10263
"2142","9 ساله","پسر","شهر",1390,"مازندران",10999,330,10669
"2143","10 ساله","دختر","شهر",1390,"مازندران",11927,391,11536
"2144","11 ساله","دختر","شهر",1390,"مازندران",11458,318,11140
"2145","12 ساله","دختر","شهر",1390,"مازندران",11285,283,11002
"2146","13 ساله","دختر","شهر",1390,"مازندران",10912,352,10560
"2147","14 ساله","دختر","شهر",1390,"مازندران",11015,477,10538
"2148","15 ساله","دختر","شهر",1390,"مازندران",11082,848,10234
"2149","16 ساله","دختر","شهر",1390,"مازندران",11573,1164,10409
"2150","17 ساله","دختر","شهر",1390,"مازندران",12552,2661,9891
"2151","18 ساله","دختر","شهر",1390,"مازندران",13847,5017,8830
"2152","19 ساله","دختر","شهر",1390,"مازندران",15382,5342,10040
"2153","6 ساله","دختر","شهر",1390,"مازندران",10641,2341,8300
"2154","7 ساله","دختر","شهر",1390,"مازندران",9945,338,9607
"2155","8 ساله","دختر","شهر",1390,"مازندران",10258,286,9972
"2156","9 ساله","دختر","شهر",1390,"مازندران",10118,247,9871
"2157","10 ساله","پسر","غیرساکن",1390,"مازندران",0,0,0
"2158","11 ساله","پسر","غیرساکن",1390,"مازندران",0,0,0
"2159","12 ساله","پسر","غیرساکن",1390,"مازندران",0,0,0
"2160","13 ساله","پسر","غیرساکن",1390,"مازندران",0,0,0
"2161","14 ساله","پسر","غیرساکن",1390,"مازندران",0,0,0
"2162","15 ساله","پسر","غیرساکن",1390,"مازندران",0,0,0
"2163","16 ساله","پسر","غیرساکن",1390,"مازندران",0,0,0
"2164","17 ساله","پسر","غیرساکن",1390,"مازندران",0,0,0
"2165","18 ساله","پسر","غیرساکن",1390,"مازندران",0,0,0
"2166","19 ساله","پسر","غیرساکن",1390,"مازندران",0,0,0
"2167","6 ساله","پسر","غیرساکن",1390,"مازندران",0,0,0
"2168","7 ساله","پسر","غیرساکن",1390,"مازندران",0,0,0
"2169","8 ساله","پسر","غیرساکن",1390,"مازندران",0,0,0
"2170","9 ساله","پسر","غیرساکن",1390,"مازندران",0,0,0
"2171","10 ساله","دختر","غیرساکن",1390,"مازندران",0,0,0
"2172","11 ساله","دختر","غیرساکن",1390,"مازندران",0,0,0
"2173","12 ساله","دختر","غیرساکن",1390,"مازندران",0,0,0
"2174","13 ساله","دختر","غیرساکن",1390,"مازندران",0,0,0
"2175","14 ساله","دختر","غیرساکن",1390,"مازندران",0,0,0
"2176","15 ساله","دختر","غیرساکن",1390,"مازندران",0,0,0
"2177","16 ساله","دختر","غیرساکن",1390,"مازندران",0,0,0
"2178","17 ساله","دختر","غیرساکن",1390,"مازندران",0,0,0
"2179","18 ساله","دختر","غیرساکن",1390,"مازندران",0,0,0
"2180","19 ساله","دختر","غیرساکن",1390,"مازندران",0,0,0
"2181","6 ساله","دختر","غیرساکن",1390,"مازندران",0,0,0
"2182","7 ساله","دختر","غیرساکن",1390,"مازندران",0,0,0
"2183","8 ساله","دختر","غیرساکن",1390,"مازندران",0,0,0
"2184","9 ساله","دختر","غیرساکن",1390,"مازندران",0,0,0
"2185","10 ساله","پسر","روستا",1390,"مركزئ",2384,167,2217
"2186","11 ساله","پسر","روستا",1390,"مركزئ",2383,183,2200
"2187","12 ساله","پسر","روستا",1390,"مركزئ",2440,228,2212
"2188","13 ساله","پسر","روستا",1390,"مركزئ",2588,335,2253
"2189","14 ساله","پسر","روستا",1390,"مركزئ",2835,527,2308
"2190","15 ساله","پسر","روستا",1390,"مركزئ",3026,851,2175
"2191","16 ساله","پسر","روستا",1390,"مركزئ",3329,1254,2075
"2192","17 ساله","پسر","روستا",1390,"مركزئ",3488,1917,1571
"2193","18 ساله","پسر","روستا",1390,"مركزئ",3754,2705,1049
"2194","19 ساله","پسر","روستا",1390,"مركزئ",3299,2485,814
"2195","6 ساله","پسر","روستا",1390,"مركزئ",2582,689,1893
"2196","7 ساله","پسر","روستا",1390,"مركزئ",2469,220,2249
"2197","8 ساله","پسر","روستا",1390,"مركزئ",2516,197,2319
"2198","9 ساله","پسر","روستا",1390,"مركزئ",2291,168,2123
"2199","10 ساله","دختر","روستا",1390,"مركزئ",2234,173,2061
"2200","11 ساله","دختر","روستا",1390,"مركزئ",2140,224,1916
"2201","12 ساله","دختر","روستا",1390,"مركزئ",2336,353,1983
"2202","13 ساله","دختر","روستا",1390,"مركزئ",2335,483,1852
"2203","14 ساله","دختر","روستا",1390,"مركزئ",2633,868,1765
"2204","15 ساله","دختر","روستا",1390,"مركزئ",2703,1098,1605
"2205","16 ساله","دختر","روستا",1390,"مركزئ",2869,1405,1464
"2206","17 ساله","دختر","روستا",1390,"مركزئ",3165,2050,1115
"2207","18 ساله","دختر","روستا",1390,"مركزئ",3253,2497,756
"2208","19 ساله","دختر","روستا",1390,"مركزئ",3180,2591,589
"2209","6 ساله","دختر","روستا",1390,"مركزئ",2426,597,1829
"2210","7 ساله","دختر","روستا",1390,"مركزئ",2311,186,2125
"2211","8 ساله","دختر","روستا",1390,"مركزئ",2275,199,2076
"2212","9 ساله","دختر","روستا",1390,"مركزئ",2211,155,2056
"2213","10 ساله","پسر","شهر",1390,"مركزئ",7556,179,7377
"2214","11 ساله","پسر","شهر",1390,"مركزئ",7469,169,7300
"2215","12 ساله","پسر","شهر",1390,"مركزئ",7708,211,7497
"2216","13 ساله","پسر","شهر",1390,"مركزئ",7657,264,7393
"2217","14 ساله","پسر","شهر",1390,"مركزئ",7882,394,7488
"2218","15 ساله","پسر","شهر",1390,"مركزئ",7709,688,7021
"2219","16 ساله","پسر","شهر",1390,"مركزئ",8393,1200,7193
"2220","17 ساله","پسر","شهر",1390,"مركزئ",9033,2678,6355
"2221","18 ساله","پسر","شهر",1390,"مركزئ",9138,3834,5304
"2222","19 ساله","پسر","شهر",1390,"مركزئ",9014,3840,5174
"2223","6 ساله","پسر","شهر",1390,"مركزئ",7960,1673,6287
"2224","7 ساله","پسر","شهر",1390,"مركزئ",7321,292,7029
"2225","8 ساله","پسر","شهر",1390,"مركزئ",7257,224,7033
"2226","9 ساله","پسر","شهر",1390,"مركزئ",7269,185,7084
"2227","10 ساله","دختر","شهر",1390,"مركزئ",7187,183,7004
"2228","11 ساله","دختر","شهر",1390,"مركزئ",7337,179,7158
"2229","12 ساله","دختر","شهر",1390,"مركزئ",7493,211,7282
"2230","13 ساله","دختر","شهر",1390,"مركزئ",7641,259,7382
"2231","14 ساله","دختر","شهر",1390,"مركزئ",7544,447,7097
"2232","15 ساله","دختر","شهر",1390,"مركزئ",7520,714,6806
"2233","16 ساله","دختر","شهر",1390,"مركزئ",8155,1195,6960
"2234","17 ساله","دختر","شهر",1390,"مركزئ",8407,2508,5899
"2235","18 ساله","دختر","شهر",1390,"مركزئ",8992,4378,4614
"2236","19 ساله","دختر","شهر",1390,"مركزئ",10072,4800,5272
"2237","6 ساله","دختر","شهر",1390,"مركزئ",7329,1513,5816
"2238","7 ساله","دختر","شهر",1390,"مركزئ",7268,228,7040
"2239","8 ساله","دختر","شهر",1390,"مركزئ",7143,215,6928
"2240","9 ساله","دختر","شهر",1390,"مركزئ",6887,170,6717
"2241","10 ساله","پسر","غیرساکن",1390,"مركزئ",0,0,0
"2242","11 ساله","پسر","غیرساکن",1390,"مركزئ",0,0,0
"2243","12 ساله","پسر","غیرساکن",1390,"مركزئ",0,0,0
"2244","13 ساله","پسر","غیرساکن",1390,"مركزئ",0,0,0
"2245","14 ساله","پسر","غیرساکن",1390,"مركزئ",0,0,0
"2246","15 ساله","پسر","غیرساکن",1390,"مركزئ",0,0,0
"2247","16 ساله","پسر","غیرساکن",1390,"مركزئ",0,0,0
"2248","17 ساله","پسر","غیرساکن",1390,"مركزئ",0,0,0
"2249","18 ساله","پسر","غیرساکن",1390,"مركزئ",0,0,0
"2250","19 ساله","پسر","غیرساکن",1390,"مركزئ",0,0,0
"2251","6 ساله","پسر","غیرساکن",1390,"مركزئ",0,0,0
"2252","7 ساله","پسر","غیرساکن",1390,"مركزئ",0,0,0
"2253","8 ساله","پسر","غیرساکن",1390,"مركزئ",0,0,0
"2254","9 ساله","پسر","غیرساکن",1390,"مركزئ",0,0,0
"2255","10 ساله","دختر","غیرساکن",1390,"مركزئ",0,0,0
"2256","11 ساله","دختر","غیرساکن",1390,"مركزئ",0,0,0
"2257","12 ساله","دختر","غیرساکن",1390,"مركزئ",0,0,0
"2258","13 ساله","دختر","غیرساکن",1390,"مركزئ",0,0,0
"2259","14 ساله","دختر","غیرساکن",1390,"مركزئ",0,0,0
"2260","15 ساله","دختر","غیرساکن",1390,"مركزئ",0,0,0
"2261","16 ساله","دختر","غیرساکن",1390,"مركزئ",0,0,0
"2262","17 ساله","دختر","غیرساکن",1390,"مركزئ",0,0,0
"2263","18 ساله","دختر","غیرساکن",1390,"مركزئ",0,0,0
"2264","19 ساله","دختر","غیرساکن",1390,"مركزئ",0,0,0
"2265","6 ساله","دختر","غیرساکن",1390,"مركزئ",0,0,0
"2266","7 ساله","دختر","غیرساکن",1390,"مركزئ",0,0,0
"2267","8 ساله","دختر","غیرساکن",1390,"مركزئ",0,0,0
"2268","9 ساله","دختر","غیرساکن",1390,"مركزئ",0,0,0
"2269","10 ساله","پسر","روستا",1390,"هرمزگان",7442,409,7033
"2270","11 ساله","پسر","روستا",1390,"هرمزگان",7577,498,7079
"2271","12 ساله","پسر","روستا",1390,"هرمزگان",8078,690,7388
"2272","13 ساله","پسر","روستا",1390,"هرمزگان",8465,824,7641
"2273","14 ساله","پسر","روستا",1390,"هرمزگان",8611,1178,7433
"2274","15 ساله","پسر","روستا",1390,"هرمزگان",8550,1650,6900
"2275","16 ساله","پسر","روستا",1390,"هرمزگان",8554,2386,6168
"2276","17 ساله","پسر","روستا",1390,"هرمزگان",9076,4082,4994
"2277","18 ساله","پسر","روستا",1390,"هرمزگان",9383,6077,3306
"2278","19 ساله","پسر","روستا",1390,"هرمزگان",9491,7014,2477
"2279","6 ساله","پسر","روستا",1390,"هرمزگان",7924,2107,5817
"2280","7 ساله","پسر","روستا",1390,"هرمزگان",7698,540,7158
"2281","8 ساله","پسر","روستا",1390,"هرمزگان",7729,477,7252
"2282","9 ساله","پسر","روستا",1390,"هرمزگان",7543,441,7102
"2283","10 ساله","دختر","روستا",1390,"هرمزگان",7406,513,6893
"2284","11 ساله","دختر","روستا",1390,"هرمزگان",7030,598,6432
"2285","12 ساله","دختر","روستا",1390,"هرمزگان",7993,1078,6915
"2286","13 ساله","دختر","روستا",1390,"هرمزگان",7923,1360,6563
"2287","14 ساله","دختر","روستا",1390,"هرمزگان",8189,1954,6235
"2288","15 ساله","دختر","روستا",1390,"هرمزگان",8278,2560,5718
"2289","16 ساله","دختر","روستا",1390,"هرمزگان",8329,3029,5300
"2290","17 ساله","دختر","روستا",1390,"هرمزگان",8772,4538,4234
"2291","18 ساله","دختر","روستا",1390,"هرمزگان",9096,6517,2579
"2292","19 ساله","دختر","روستا",1390,"هرمزگان",9284,7381,1903
"2293","6 ساله","دختر","روستا",1390,"هرمزگان",7739,2093,5646
"2294","7 ساله","دختر","روستا",1390,"هرمزگان",7321,518,6803
"2295","8 ساله","دختر","روستا",1390,"هرمزگان",7371,453,6918
"2296","9 ساله","دختر","روستا",1390,"هرمزگان",7372,434,6938
"2297","10 ساله","پسر","شهر",1390,"هرمزگان",6389,432,5957
"2298","11 ساله","پسر","شهر",1390,"هرمزگان",5952,323,5629
"2299","12 ساله","پسر","شهر",1390,"هرمزگان",6406,441,5965
"2300","13 ساله","پسر","شهر",1390,"هرمزگان",6296,392,5904
"2301","14 ساله","پسر","شهر",1390,"هرمزگان",6444,577,5867
"2302","15 ساله","پسر","شهر",1390,"هرمزگان",6931,864,6067
"2303","16 ساله","پسر","شهر",1390,"هرمزگان",7384,1226,6158
"2304","17 ساله","پسر","شهر",1390,"هرمزگان",7415,2495,4920
"2305","18 ساله","پسر","شهر",1390,"هرمزگان",7464,3974,3490
"2306","19 ساله","پسر","شهر",1390,"هرمزگان",8676,5574,3102
"2307","6 ساله","پسر","شهر",1390,"هرمزگان",7243,1910,5333
"2308","7 ساله","پسر","شهر",1390,"هرمزگان",6806,502,6304
"2309","8 ساله","پسر","شهر",1390,"هرمزگان",6974,458,6516
"2310","9 ساله","پسر","شهر",1390,"هرمزگان",6787,389,6398
"2311","10 ساله","دختر","شهر",1390,"هرمزگان",6275,385,5890
"2312","11 ساله","دختر","شهر",1390,"هرمزگان",5726,312,5414
"2313","12 ساله","دختر","شهر",1390,"هرمزگان",6261,380,5881
"2314","13 ساله","دختر","شهر",1390,"هرمزگان",6047,428,5619
"2315","14 ساله","دختر","شهر",1390,"هرمزگان",6228,640,5588
"2316","15 ساله","دختر","شهر",1390,"هرمزگان",6459,878,5581
"2317","16 ساله","دختر","شهر",1390,"هرمزگان",6600,1216,5384
"2318","17 ساله","دختر","شهر",1390,"هرمزگان",7190,2332,4858
"2319","18 ساله","دختر","شهر",1390,"هرمزگان",7369,4145,3224
"2320","19 ساله","دختر","شهر",1390,"هرمزگان",8307,4725,3582
"2321","6 ساله","دختر","شهر",1390,"هرمزگان",7084,1903,5181
"2322","7 ساله","دختر","شهر",1390,"هرمزگان",6500,443,6057
"2323","8 ساله","دختر","شهر",1390,"هرمزگان",6550,352,6198
"2324","9 ساله","دختر","شهر",1390,"هرمزگان",6485,407,6078
"2325","10 ساله","پسر","غیرساکن",1390,"هرمزگان",36,16,20
"2326","11 ساله","پسر","غیرساکن",1390,"هرمزگان",28,14,14
"2327","12 ساله","پسر","غیرساکن",1390,"هرمزگان",38,20,18
"2328","13 ساله","پسر","غیرساکن",1390,"هرمزگان",30,13,17
"2329","14 ساله","پسر","غیرساکن",1390,"هرمزگان",34,25,9
"2330","15 ساله","پسر","غیرساکن",1390,"هرمزگان",37,25,12
"2331","16 ساله","پسر","غیرساکن",1390,"هرمزگان",35,26,9
"2332","17 ساله","پسر","غیرساکن",1390,"هرمزگان",47,42,5
"2333","18 ساله","پسر","غیرساکن",1390,"هرمزگان",49,45,4
"2334","19 ساله","پسر","غیرساکن",1390,"هرمزگان",47,47,0
"2335","6 ساله","پسر","غیرساکن",1390,"هرمزگان",16,11,5
"2336","7 ساله","پسر","غیرساکن",1390,"هرمزگان",24,7,17
"2337","8 ساله","پسر","غیرساکن",1390,"هرمزگان",27,10,17
"2338","9 ساله","پسر","غیرساکن",1390,"هرمزگان",36,6,30
"2339","10 ساله","دختر","غیرساکن",1390,"هرمزگان",25,13,12
"2340","11 ساله","دختر","غیرساکن",1390,"هرمزگان",23,12,11
"2341","12 ساله","دختر","غیرساکن",1390,"هرمزگان",20,13,7
"2342","13 ساله","دختر","غیرساکن",1390,"هرمزگان",25,17,8
"2343","14 ساله","دختر","غیرساکن",1390,"هرمزگان",30,21,9
"2344","15 ساله","دختر","غیرساکن",1390,"هرمزگان",42,34,8
"2345","16 ساله","دختر","غیرساکن",1390,"هرمزگان",29,25,4
"2346","17 ساله","دختر","غیرساکن",1390,"هرمزگان",47,41,6
"2347","18 ساله","دختر","غیرساکن",1390,"هرمزگان",34,31,3
"2348","19 ساله","دختر","غیرساکن",1390,"هرمزگان",40,37,3
"2349","6 ساله","دختر","غیرساکن",1390,"هرمزگان",31,20,11
"2350","7 ساله","دختر","غیرساکن",1390,"هرمزگان",22,9,13
"2351","8 ساله","دختر","غیرساکن",1390,"هرمزگان",28,9,19
"2352","9 ساله","دختر","غیرساکن",1390,"هرمزگان",28,10,18
"2353","10 ساله","پسر","روستا",1390,"همدان",5208,204,5004
"2354","11 ساله","پسر","روستا",1390,"همدان",5230,210,5020
"2355","12 ساله","پسر","روستا",1390,"همدان",5601,304,5297
"2356","13 ساله","پسر","روستا",1390,"همدان",5489,480,5009
"2357","14 ساله","پسر","روستا",1390,"همدان",5950,879,5071
"2358","15 ساله","پسر","روستا",1390,"همدان",6444,1588,4856
"2359","16 ساله","پسر","روستا",1390,"همدان",6793,2297,4496
"2360","17 ساله","پسر","روستا",1390,"همدان",7335,3942,3393
"2361","18 ساله","پسر","روستا",1390,"همدان",7672,5333,2339
"2362","19 ساله","پسر","روستا",1390,"همدان",7988,6156,1832
"2363","6 ساله","پسر","روستا",1390,"همدان",5529,1210,4319
"2364","7 ساله","پسر","روستا",1390,"همدان",5221,218,5003
"2365","8 ساله","پسر","روستا",1390,"همدان",5147,219,4928
"2366","9 ساله","پسر","روستا",1390,"همدان",5187,231,4956
"2367","10 ساله","دختر","روستا",1390,"همدان",4941,208,4733
"2368","11 ساله","دختر","روستا",1390,"همدان",4980,423,4557
"2369","12 ساله","دختر","روستا",1390,"همدان",5240,792,4448
"2370","13 ساله","دختر","روستا",1390,"همدان",5243,1154,4089
"2371","14 ساله","دختر","روستا",1390,"همدان",5348,1951,3397
"2372","15 ساله","دختر","روستا",1390,"همدان",6112,2900,3212
"2373","16 ساله","دختر","روستا",1390,"همدان",6559,3563,2996
"2374","17 ساله","دختر","روستا",1390,"همدان",6964,4900,2064
"2375","18 ساله","دختر","روستا",1390,"همدان",7240,5907,1333
"2376","19 ساله","دختر","روستا",1390,"همدان",7496,6280,1216
"2377","6 ساله","دختر","روستا",1390,"همدان",5151,1068,4083
"2378","7 ساله","دختر","روستا",1390,"همدان",5208,229,4979
"2379","8 ساله","دختر","روستا",1390,"همدان",4905,169,4736
"2380","9 ساله","دختر","روستا",1390,"همدان",4990,189,4801
"2381","10 ساله","پسر","شهر",1390,"همدان",7312,184,7128
"2382","11 ساله","پسر","شهر",1390,"همدان",7241,205,7036
"2383","12 ساله","پسر","شهر",1390,"همدان",7520,197,7323
"2384","13 ساله","پسر","شهر",1390,"همدان",7488,244,7244
"2385","14 ساله","پسر","شهر",1390,"همدان",8045,391,7654
"2386","15 ساله","پسر","شهر",1390,"همدان",8345,665,7680
"2387","16 ساله","پسر","شهر",1390,"همدان",8808,1068,7740
"2388","17 ساله","پسر","شهر",1390,"همدان",9123,2595,6528
"2389","18 ساله","پسر","شهر",1390,"همدان",9785,4318,5467
"2390","19 ساله","پسر","شهر",1390,"همدان",10130,4503,5627
"2391","6 ساله","پسر","شهر",1390,"همدان",7018,1558,5460
"2392","7 ساله","پسر","شهر",1390,"همدان",6453,216,6237
"2393","8 ساله","پسر","شهر",1390,"همدان",6465,204,6261
"2394","9 ساله","پسر","شهر",1390,"همدان",6665,202,6463
"2395","10 ساله","دختر","شهر",1390,"همدان",6910,203,6707
"2396","11 ساله","دختر","شهر",1390,"همدان",7172,176,6996
"2397","12 ساله","دختر","شهر",1390,"همدان",7467,193,7274
"2398","13 ساله","دختر","شهر",1390,"همدان",7480,284,7196
"2399","14 ساله","دختر","شهر",1390,"همدان",7846,483,7363
"2400","15 ساله","دختر","شهر",1390,"همدان",8205,907,7298
"2401","16 ساله","دختر","شهر",1390,"همدان",8612,1495,7117
"2402","17 ساله","دختر","شهر",1390,"همدان",8883,2825,6058
"2403","18 ساله","دختر","شهر",1390,"همدان",9493,4946,4547
"2404","19 ساله","دختر","شهر",1390,"همدان",11158,5430,5728
"2405","6 ساله","دختر","شهر",1390,"همدان",6552,1439,5113
"2406","7 ساله","دختر","شهر",1390,"همدان",6057,220,5837
"2407","8 ساله","دختر","شهر",1390,"همدان",6264,202,6062
"2408","9 ساله","دختر","شهر",1390,"همدان",6300,177,6123
"2409","10 ساله","پسر","غیرساکن",1390,"همدان",7,3,4
"2410","11 ساله","پسر","غیرساکن",1390,"همدان",15,6,9
"2411","12 ساله","پسر","غیرساکن",1390,"همدان",9,4,5
"2412","13 ساله","پسر","غیرساکن",1390,"همدان",11,8,3
"2413","14 ساله","پسر","غیرساکن",1390,"همدان",11,5,6
"2414","15 ساله","پسر","غیرساکن",1390,"همدان",16,10,6
"2415","16 ساله","پسر","غیرساکن",1390,"همدان",17,16,1
"2416","17 ساله","پسر","غیرساکن",1390,"همدان",20,14,6
"2417","18 ساله","پسر","غیرساکن",1390,"همدان",17,14,3
"2418","19 ساله","پسر","غیرساکن",1390,"همدان",12,9,3
"2419","6 ساله","پسر","غیرساکن",1390,"همدان",14,13,1
"2420","7 ساله","پسر","غیرساکن",1390,"همدان",7,3,4
"2421","8 ساله","پسر","غیرساکن",1390,"همدان",8,4,4
"2422","9 ساله","پسر","غیرساکن",1390,"همدان",14,9,5
"2423","10 ساله","دختر","غیرساکن",1390,"همدان",9,8,1
"2424","11 ساله","دختر","غیرساکن",1390,"همدان",7,4,3
"2425","12 ساله","دختر","غیرساکن",1390,"همدان",11,10,1
"2426","13 ساله","دختر","غیرساکن",1390,"همدان",19,18,1
"2427","14 ساله","دختر","غیرساکن",1390,"همدان",12,11,1
"2428","15 ساله","دختر","غیرساکن",1390,"همدان",7,7,0
"2429","16 ساله","دختر","غیرساکن",1390,"همدان",8,7,1
"2430","17 ساله","دختر","غیرساکن",1390,"همدان",12,12,0
"2431","18 ساله","دختر","غیرساکن",1390,"همدان",12,11,1
"2432","19 ساله","دختر","غیرساکن",1390,"همدان",9,9,0
"2433","6 ساله","دختر","غیرساکن",1390,"همدان",2,2,0
"2434","7 ساله","دختر","غیرساکن",1390,"همدان",10,5,5
"2435","8 ساله","دختر","غیرساکن",1390,"همدان",8,3,5
"2436","9 ساله","دختر","غیرساکن",1390,"همدان",14,7,7
"2437","10 ساله","پسر","روستا",1390,"يزد",1366,114,1252
"2438","11 ساله","پسر","روستا",1390,"يزد",1282,95,1187
"2439","12 ساله","پسر","روستا",1390,"يزد",1382,99,1283
"2440","13 ساله","پسر","روستا",1390,"يزد",1348,147,1201
"2441","14 ساله","پسر","روستا",1390,"يزد",1265,151,1114
"2442","15 ساله","پسر","روستا",1390,"يزد",1367,316,1051
"2443","16 ساله","پسر","روستا",1390,"يزد",1461,428,1033
"2444","17 ساله","پسر","روستا",1390,"يزد",1548,689,859
"2445","18 ساله","پسر","روستا",1390,"يزد",2119,1397,722
"2446","19 ساله","پسر","روستا",1390,"يزد",2897,2257,640
"2447","6 ساله","پسر","روستا",1390,"يزد",1356,366,990
"2448","7 ساله","پسر","روستا",1390,"يزد",1399,132,1267
"2449","8 ساله","پسر","روستا",1390,"يزد",1370,122,1248
"2450","9 ساله","پسر","روستا",1390,"يزد",1459,99,1360
"2451","10 ساله","دختر","روستا",1390,"يزد",1275,79,1196
"2452","11 ساله","دختر","روستا",1390,"يزد",1229,87,1142
"2453","12 ساله","دختر","روستا",1390,"يزد",1251,113,1138
"2454","13 ساله","دختر","روستا",1390,"يزد",1234,122,1112
"2455","14 ساله","دختر","روستا",1390,"يزد",1178,184,994
"2456","15 ساله","دختر","روستا",1390,"يزد",1200,252,948
"2457","16 ساله","دختر","روستا",1390,"يزد",1150,276,874
"2458","17 ساله","دختر","روستا",1390,"يزد",1350,597,753
"2459","18 ساله","دختر","روستا",1390,"يزد",1477,907,570
"2460","19 ساله","دختر","روستا",1390,"يزد",1506,955,551
"2461","6 ساله","دختر","روستا",1390,"يزد",1390,376,1014
"2462","7 ساله","دختر","روستا",1390,"يزد",1249,121,1128
"2463","8 ساله","دختر","روستا",1390,"يزد",1382,79,1303
"2464","9 ساله","دختر","روستا",1390,"يزد",1304,88,1216
"2465","10 ساله","پسر","شهر",1390,"يزد",7080,433,6647
"2466","11 ساله","پسر","شهر",1390,"يزد",6793,349,6444
"2467","12 ساله","پسر","شهر",1390,"يزد",7169,449,6720
"2468","13 ساله","پسر","شهر",1390,"يزد",6698,451,6247
"2469","14 ساله","پسر","شهر",1390,"يزد",6681,628,6053
"2470","15 ساله","پسر","شهر",1390,"يزد",6513,949,5564
"2471","16 ساله","پسر","شهر",1390,"يزد",6778,1309,5469
"2472","17 ساله","پسر","شهر",1390,"يزد",7056,2131,4925
"2473","18 ساله","پسر","شهر",1390,"يزد",7961,3189,4772
"2474","19 ساله","پسر","شهر",1390,"يزد",8471,3589,4882
"2475","6 ساله","پسر","شهر",1390,"يزد",7555,1823,5732
"2476","7 ساله","پسر","شهر",1390,"يزد",7219,561,6658
"2477","8 ساله","پسر","شهر",1390,"يزد",7200,469,6731
"2478","9 ساله","پسر","شهر",1390,"يزد",7114,373,6741
"2479","10 ساله","دختر","شهر",1390,"يزد",6727,390,6337
"2480","11 ساله","دختر","شهر",1390,"يزد",6603,393,6210
"2481","12 ساله","دختر","شهر",1390,"يزد",6739,474,6265
"2482","13 ساله","دختر","شهر",1390,"يزد",6360,488,5872
"2483","14 ساله","دختر","شهر",1390,"يزد",6272,540,5732
"2484","15 ساله","دختر","شهر",1390,"يزد",6246,838,5408
"2485","16 ساله","دختر","شهر",1390,"يزد",6289,1047,5242
"2486","17 ساله","دختر","شهر",1390,"يزد",6681,1916,4765
"2487","18 ساله","دختر","شهر",1390,"يزد",7811,3042,4769
"2488","19 ساله","دختر","شهر",1390,"يزد",8361,3202,5159
"2489","6 ساله","دختر","شهر",1390,"يزد",7378,1881,5497
"2490","7 ساله","دختر","شهر",1390,"يزد",6930,506,6424
"2491","8 ساله","دختر","شهر",1390,"يزد",6944,444,6500
"2492","9 ساله","دختر","شهر",1390,"يزد",6822,346,6476
"2493","10 ساله","پسر","غیرساکن",1390,"يزد",1,1,0
"2494","11 ساله","پسر","غیرساکن",1390,"يزد",0,0,0
"2495","12 ساله","پسر","غیرساکن",1390,"يزد",0,0,0
"2496","13 ساله","پسر","غیرساکن",1390,"يزد",0,0,0
"2497","14 ساله","پسر","غیرساکن",1390,"يزد",0,0,0
"2498","15 ساله","پسر","غیرساکن",1390,"يزد",0,0,0
"2499","16 ساله","پسر","غیرساکن",1390,"يزد",0,0,0
"2500","17 ساله","پسر","غیرساکن",1390,"يزد",0,0,0
"2501","18 ساله","پسر","غیرساکن",1390,"يزد",0,0,0
"2502","19 ساله","پسر","غیرساکن",1390,"يزد",0,0,0
"2503","6 ساله","پسر","غیرساکن",1390,"يزد",0,0,0
"2504","7 ساله","پسر","غیرساکن",1390,"يزد",1,1,0
"2505","8 ساله","پسر","غیرساکن",1390,"يزد",1,1,0
"2506","9 ساله","پسر","غیرساکن",1390,"يزد",0,0,0
"2507","10 ساله","دختر","غیرساکن",1390,"يزد",0,0,0
"2508","11 ساله","دختر","غیرساکن",1390,"يزد",0,0,0
"2509","12 ساله","دختر","غیرساکن",1390,"يزد",0,0,0
"2510","13 ساله","دختر","غیرساکن",1390,"يزد",0,0,0
"2511","14 ساله","دختر","غیرساکن",1390,"يزد",0,0,0
"2512","15 ساله","دختر","غیرساکن",1390,"يزد",0,0,0
"2513","16 ساله","دختر","غیرساکن",1390,"يزد",0,0,0
"2514","17 ساله","دختر","غیرساکن",1390,"يزد",0,0,0
"2515","18 ساله","دختر","غیرساکن",1390,"يزد",0,0,0
"2516","19 ساله","دختر","غیرساکن",1390,"يزد",0,0,0
"2517","6 ساله","دختر","غیرساکن",1390,"يزد",0,0,0
"2518","7 ساله","دختر","غیرساکن",1390,"يزد",0,0,0
"2519","8 ساله","دختر","غیرساکن",1390,"يزد",0,0,0
"2520","9 ساله","دختر","غیرساکن",1390,"يزد",0,0,0
